False
23
130
30,50
5,5,5,5,5,5,5,5,5,5,5,5,5,5,5,5,5,5,5,5,5,5,5,5,5,5,5,5,5,5,5,5,5,5,5,5,5,5,5,5,5,5,5,5,5,5,5,5,5,5
5,10,10,10,10,10,10,10,10,10,5,18,10,4,3,3,3,10,3,3,3,3,18,4,3,3,3,3,3,3,3,3,3,3,3,3,3,3,3,3,3,3,3,3,3,3,3,3,3,5
5,10,10,10,10,10,10,10,10,10,5,3,3,4,10,3,3,3,3,10,3,3,10,4,3,3,3,3,3,10,10,3,3,3,3,3,3,3,3,3,3,3,3,3,3,3,3,3,3,5
5,0,0,0,0,0,0,0,0,0,5,3,3,4,3,3,3,3,10,3,10,3,3,4,3,3,3,3,3,3,3,3,3,3,3,3,3,3,3,3,3,3,3,3,3,3,3,3,3,5
5,8,8,8,8,8,8,8,8,8,5,10,3,4,3,10,3,3,3,3,3,3,3,4,3,3,3,3,3,3,3,3,3,3,3,3,3,3,3,3,3,3,3,4,4,4,3,3,3,5
5,4,4,4,4,4,4,4,4,4,5,3,3,4,10,3,10,3,3,3,10,3,3,4,3,3,3,3,3,3,8,3,8,3,3,3,3,3,3,3,3,3,3,4,18,4,3,3,3,5
5,0,0,0,0,0,0,0,0,0,5,10,3,4,10,10,3,10,3,3,3,3,3,4,3,3,3,3,3,3,3,3,3,3,3,3,3,3,3,3,3,3,8,4,4,4,3,3,3,5
5,0,0,0,0,0,0,0,0,0,5,3,3,4,3,3,3,3,3,3,3,3,3,4,3,3,3,3,3,3,3,3,3,3,3,3,3,3,3,3,3,3,3,3,3,3,3,3,3,5
5,0,0,0,0,0,0,0,0,0,5,3,3,4,10,10,10,10,10,10,10,10,10,4,3,3,3,3,3,3,3,3,3,3,3,3,3,3,3,3,3,3,3,3,3,3,3,3,3,5
5,0,0,0,0,0,0,0,0,0,5,3,3,4,3,10,3,3,3,3,3,18,3,4,3,3,3,3,3,3,3,3,3,3,3,3,3,3,3,3,3,3,3,3,3,3,3,3,3,5
5,0,0,0,0,1,0,0,0,0,5,3,10,4,3,18,3,3,3,4,4,4,4,4,3,3,3,3,3,3,3,3,3,3,3,3,3,3,3,3,3,3,3,3,3,3,3,3,3,5
5,0,0,0,0,0,0,0,0,0,5,3,10,4,10,3,18,3,3,3,3,3,3,4,3,3,3,3,3,3,3,3,3,3,3,3,3,3,3,3,3,3,3,3,3,3,3,3,3,5
5,0,0,0,0,0,0,0,0,0,5,3,3,4,18,3,3,3,0,3,3,18,3,4,3,3,7,3,3,3,3,3,3,3,3,3,3,3,3,3,3,3,3,3,3,3,3,3,3,5
5,0,0,0,0,0,0,0,0,0,5,3,3,4,4,4,4,4,20,22,4,4,4,4,3,3,3,3,3,3,3,3,3,3,3,3,3,3,3,3,3,3,3,3,3,3,3,3,3,5
5,0,0,0,0,0,0,0,0,0,5,0,0,0,0,0,0,0,0,0,10,0,0,4,3,3,3,3,3,3,3,3,3,3,3,3,3,3,3,3,3,3,3,3,3,3,3,3,3,5
5,0,0,0,0,0,0,0,0,0,5,20,4,4,4,4,4,4,4,4,4,4,0,4,4,4,4,4,4,4,4,4,4,4,4,3,3,3,3,3,3,3,3,3,3,3,3,3,3,5
5,0,0,0,0,0,0,0,0,0,5,0,21,0,0,10,0,18,4,0,0,0,0,4,3,3,3,3,3,4,0,18,0,0,4,3,3,3,3,3,3,3,4,4,4,3,3,3,3,5
5,0,0,0,0,0,0,0,0,0,5,0,4,4,3,4,3,5,4,0,0,0,4,4,3,3,10,18,3,4,14,5,0,0,4,3,3,3,3,3,3,3,4,18,4,3,3,3,3,5
5,0,0,0,0,0,0,0,0,0,5,0,0,10,0,21,0,4,4,0,0,4,4,4,3,3,3,10,3,4,0,4,0,0,4,3,3,3,3,3,3,3,4,4,4,3,3,3,3,5
5,0,0,0,0,0,0,0,0,0,5,0,4,4,20,4,0,4,0,0,4,4,4,4,0,4,0,4,4,4,14,4,0,0,4,3,3,3,3,3,3,3,3,3,3,3,3,3,3,5
5,0,0,0,0,5,0,4,0,0,5,0,4,0,10,18,18,4,0,0,4,4,4,4,0,4,0,4,10,4,0,4,0,0,4,3,3,3,3,3,3,3,3,3,3,3,3,3,3,5
5,0,4,0,4,4,0,4,0,0,5,0,4,4,4,4,4,4,0,0,4,0,0,10,0,0,0,0,3,4,0,18,0,4,4,3,3,3,3,4,4,4,3,3,3,3,3,3,3,5
5,4,4,0,4,4,0,4,0,4,5,0,3,3,3,3,10,4,0,0,4,0,4,4,4,4,4,4,0,4,14,5,0,4,4,3,3,3,3,4,18,4,3,3,3,3,3,3,3,5
5,0,0,0,0,4,0,4,0,4,5,0,3,3,3,10,3,4,0,0,0,0,0,0,10,0,0,0,0,4,0,4,0,4,4,3,3,3,3,4,4,4,3,3,3,3,3,3,3,5
5,0,0,0,0,4,0,4,18,4,5,0,4,10,3,10,3,4,4,4,4,4,4,4,4,4,4,4,0,4,14,4,0,0,21,0,3,3,3,3,3,3,3,3,3,3,3,3,3,5
5,0,0,4,0,4,0,4,3,4,5,0,4,3,3,10,3,4,18,3,3,10,3,3,3,4,0,0,0,4,0,4,0,0,4,3,3,3,3,3,3,3,3,3,4,4,4,3,3,5
5,18,3,3,3,0,3,0,0,10,5,0,4,3,3,3,3,4,10,10,3,3,3,3,3,0,0,0,0,4,0,4,0,0,4,3,3,3,3,3,3,3,3,3,4,18,4,3,3,5
5,4,4,4,4,4,0,0,4,4,5,0,4,4,3,10,3,4,3,3,3,10,10,10,10,4,0,0,0,4,4,4,0,0,4,3,3,3,3,3,3,3,3,3,4,14,4,8,3,5
5,18,0,0,0,0,0,0,0,0,0,0,0,4,3,10,18,4,3,3,3,3,18,3,3,4,0,0,0,0,0,0,0,0,4,3,3,3,3,3,3,3,3,3,4,4,4,4,4,5
5,5,5,5,5,5,5,5,5,5,5,5,5,5,5,5,5,5,5,5,5,5,5,5,5,5,5,5,5,5,5,5,5,5,5,5,5,5,5,5,5,5,5,5,5,5,5,5,5,5