multiplayer=False
required_score=18
time=120
size_y=27
size_x=45
map_file_version=2
mapstart:
5,5,5,5,5,5,5,5,5,5,5,5,5,5,5,5,5,5,5,5,5,5,5,5,5,5,5,5,5,5,5,5,5,5,5,5,5,5,5,5,5,5,5,5,5
5,0,0,0,0,0,0,0,0,0,0,0,0,0,0,0,0,10,0,0,0,0,0,0,0,0,0,0,21,0,3,14,8,0,4,0,0,0,0,0,0,0,0,0,5
5,0,0,0,0,0,0,0,0,0,0,0,0,0,0,0,0,5,0,0,0,0,0,0,0,0,0,0,4,0,4,4,4,0,4,0,0,0,0,0,0,0,0,18,5
5,0,0,0,0,0,0,8,0,10,0,0,0,0,0,0,10,0,0,0,0,0,0,0,28,0,0,0,4,0,0,0,0,4,4,4,4,4,4,4,4,4,4,4,5
5,0,0,0,0,0,0,4,4,4,4,0,0,4,0,4,5,0,0,0,0,0,0,0,0,0,0,0,23,0,0,4,0,4,4,10,10,10,10,10,10,10,10,10,5
5,0,0,0,0,0,0,4,4,4,4,4,4,4,4,4,4,4,4,4,4,4,4,0,0,0,0,0,4,4,4,4,4,4,4,3,3,3,3,3,3,3,3,3,5
5,0,0,0,0,0,0,4,0,0,0,0,14,0,0,0,21,0,0,0,0,0,4,10,10,10,18,18,10,18,10,10,10,4,8,8,8,8,8,8,8,8,8,8,5
5,0,0,0,0,0,0,4,18,0,0,0,0,0,0,0,23,0,18,0,0,0,4,10,10,18,18,10,10,18,10,10,10,4,10,3,3,3,3,3,3,3,3,3,5
5,0,0,0,0,0,0,4,4,4,4,4,4,4,4,4,4,4,4,4,4,4,4,10,10,10,10,10,10,10,10,10,10,4,10,4,0,0,0,0,0,0,0,0,5
5,0,0,0,0,0,0,0,0,0,0,0,0,0,0,0,3,3,3,3,3,10,4,3,3,3,3,3,3,3,3,3,3,4,10,4,0,0,0,0,0,0,0,0,5
5,0,0,0,0,0,0,0,0,0,0,0,0,0,0,0,10,10,10,3,10,3,4,0,0,0,0,0,0,0,0,0,0,0,10,0,0,0,0,0,0,0,0,0,5
5,0,0,0,0,0,0,0,0,0,0,0,0,0,0,0,3,3,3,10,3,3,4,0,0,0,0,0,0,0,0,0,0,4,4,4,0,0,0,0,0,0,0,0,5
5,0,0,0,0,0,0,0,0,0,0,0,0,0,0,0,3,3,3,10,3,18,4,0,0,0,0,0,0,0,0,0,0,4,0,0,0,4,0,4,0,0,4,0,5
5,4,4,4,4,4,4,4,4,4,4,4,0,0,0,0,4,4,4,4,4,4,4,0,0,0,0,0,0,0,0,0,0,4,0,0,4,0,0,0,0,0,0,0,5
5,3,3,10,0,0,0,18,14,0,0,10,0,0,0,0,4,10,3,10,10,4,3,0,0,0,0,0,0,0,0,0,0,4,0,0,0,0,0,0,0,0,0,0,5
5,3,3,10,3,0,3,3,3,0,3,10,4,0,0,0,4,10,10,10,3,4,18,0,0,0,0,0,0,0,0,0,0,4,0,0,4,0,0,0,0,0,0,0,5
5,3,3,10,3,3,3,3,3,3,3,10,4,0,0,0,4,10,10,10,18,4,3,0,0,0,0,0,0,0,0,0,0,4,0,0,0,0,0,0,0,0,0,0,5
5,3,3,4,4,4,4,4,4,4,4,4,4,0,0,0,4,3,4,4,4,4,4,0,0,0,0,0,0,0,0,0,0,4,18,0,0,0,0,4,4,0,0,0,5
5,0,0,0,0,0,0,0,0,0,0,0,0,0,0,0,0,0,0,0,0,0,4,0,0,0,0,0,0,0,0,0,0,4,3,0,0,0,0,0,0,4,0,0,5
5,0,0,0,0,0,0,0,0,0,0,0,0,0,0,0,0,0,0,0,0,0,4,0,0,0,0,0,0,0,0,0,0,4,0,0,0,0,0,0,0,0,0,0,5
5,0,0,0,0,0,0,0,0,0,4,4,0,0,0,0,0,0,0,0,0,0,21,0,0,0,0,0,0,0,0,0,0,4,0,0,0,0,0,0,0,0,0,0,5
5,0,0,0,0,0,0,0,0,0,4,0,0,0,0,0,4,0,4,4,4,4,4,0,0,0,0,0,0,0,0,0,0,4,0,0,0,0,0,0,0,0,0,4,5
5,0,0,0,0,0,0,0,0,0,4,0,0,0,0,0,4,0,4,18,18,18,4,0,0,0,0,0,0,0,0,0,0,4,0,0,0,0,0,0,0,0,4,0,5
5,0,0,0,0,0,0,0,0,0,4,0,0,0,0,0,4,0,4,10,10,10,4,0,0,0,0,0,0,0,0,0,0,4,0,0,0,0,0,0,0,4,0,0,5
5,0,0,1,0,0,0,0,0,0,4,0,0,0,0,0,4,0,4,3,3,3,4,0,0,0,0,0,0,0,0,0,0,4,0,0,0,0,0,0,0,4,0,0,5
5,0,0,0,0,0,0,0,0,0,4,0,0,0,0,0,4,0,3,3,3,3,4,0,0,0,0,0,0,0,0,0,0,4,3,18,3,3,3,3,7,4,0,0,5
5,5,5,5,5,5,5,5,5,5,5,5,5,5,5,5,5,5,5,5,5,5,5,5,5,5,5,5,5,5,5,5,5,5,5,5,5,5,5,5,5,5,5,5,5