multiplayer=False
required_score=20
time=0
size_y=40
size_x=20
map_file_version=2
mapstart:
7,4,0,3,0,8,10,18,0,3,3,3,3,3,8,3,10,10,14,3
8,14,10,14,8,10,10,3,3,0,14,3,3,3,8,0,10,14,14,3
10,10,3,3,3,8,10,3,3,3,18,3,8,3,10,10,3,3,3,0
10,3,10,0,3,3,10,0,14,3,3,8,3,10,14,14,3,10,10,3
10,0,10,10,10,3,3,3,3,3,3,10,10,3,0,3,3,3,10,8
0,10,3,3,3,10,3,10,18,10,3,10,3,3,10,18,14,18,3,10
8,18,3,3,8,14,0,10,10,14,10,14,8,3,10,18,10,10,8,18
10,10,10,10,10,14,3,3,3,3,0,8,10,3,3,18,3,18,3,10
3,3,3,18,8,14,0,14,3,10,10,3,3,10,10,8,0,3,10,3
3,3,10,10,3,3,3,10,10,3,3,10,10,18,18,0,3,3,8,10
3,3,3,10,3,10,18,14,3,10,0,0,14,3,10,0,18,3,10,3
3,3,3,3,18,3,0,3,10,3,3,10,3,3,3,3,0,3,3,3
3,8,10,14,0,3,14,3,3,3,10,14,3,3,0,0,18,3,18,14
3,18,18,3,3,10,3,3,3,3,3,10,10,10,14,3,3,0,14,3
3,8,10,14,10,3,10,14,3,3,10,3,0,10,10,14,3,8,10,10
3,3,8,3,8,3,3,0,3,3,8,18,3,3,10,3,3,0,18,10
14,3,3,3,18,3,3,3,10,10,3,10,3,3,10,3,0,3,3,18
3,10,10,3,10,18,3,10,3,0,8,3,18,1,3,10,3,3,10,10
14,3,10,8,8,18,3,3,3,10,3,8,14,3,0,3,10,10,10,18
3,18,3,14,18,18,10,10,3,0,3,3,3,18,18,14,14,0,3,10
8,10,0,3,10,0,18,8,10,14,3,10,3,3,18,10,3,3,10,3
10,3,10,3,10,18,0,18,3,3,8,0,0,10,18,18,8,10,3,10
3,3,10,3,10,3,3,10,18,3,10,18,14,8,3,10,10,10,3,3
3,18,3,3,3,10,10,10,14,10,3,10,3,3,14,10,3,3,10,14
3,3,3,3,3,3,10,10,8,18,3,0,0,3,10,3,10,18,0,8
18,0,10,3,3,14,3,14,10,3,10,10,10,18,0,10,10,10,18,3
3,10,0,10,14,10,3,3,3,10,3,14,3,14,0,3,18,3,8,3
10,0,3,3,3,3,3,3,18,3,3,3,18,10,8,3,3,10,3,8
10,18,18,3,18,8,3,14,14,10,8,3,8,3,0,14,10,3,3,3
10,3,8,3,3,0,3,3,3,10,8,18,10,14,10,10,10,3,10,3
10,10,14,10,10,10,3,3,10,8,0,8,3,14,3,3,3,3,0,8
14,10,10,14,3,10,3,18,10,10,18,14,3,3,14,10,14,0,3,18
3,3,10,18,10,8,8,0,0,3,18,10,8,14,10,3,3,8,3,10
10,10,8,3,3,10,0,3,14,3,3,10,0,3,14,18,14,14,10,3
3,10,14,18,8,10,3,18,3,0,3,18,3,10,14,8,3,3,10,3
18,3,3,10,14,3,10,3,3,3,8,8,10,10,0,18,3,3,10,8
3,14,10,10,3,10,18,8,18,3,0,10,3,18,18,3,14,18,3,0
0,3,3,10,3,8,14,8,3,3,18,3,3,3,3,8,3,10,0,0
3,3,10,0,3,3,0,3,3,3,3,3,10,8,10,3,3,3,14,10
10,3,3,10,10,8,10,14,14,0,14,10,14,10,8,3,10,8,10,14