False
10
40
17,25
5,5,5,5,5,5,5,5,5,5,5,5,5,5,5,5,5,5,5,5,5,5,5,5,5
5,10,4,10,3,3,3,3,3,3,3,3,3,3,3,3,3,3,3,3,3,3,8,3,5
5,1,4,3,10,4,3,4,3,3,3,3,3,3,3,3,3,4,3,3,3,3,3,3,5
5,0,4,10,3,4,3,4,3,3,3,3,3,3,3,3,3,4,3,10,3,3,3,3,5
5,0,4,3,10,4,3,4,4,4,4,4,4,4,3,3,3,4,3,10,4,4,10,3,5
5,0,4,10,3,4,3,4,3,3,3,18,18,4,3,3,3,4,3,10,4,18,10,3,5
5,0,4,3,10,4,3,21,0,3,3,3,3,4,3,3,3,4,3,3,4,18,10,3,5
5,0,4,10,3,4,4,4,4,3,3,3,4,4,3,3,3,4,3,3,4,18,18,3,5
5,0,4,3,10,3,3,4,4,3,3,3,4,4,3,3,3,4,10,3,4,4,4,4,5
5,0,4,10,3,3,3,4,4,3,8,3,4,4,3,10,3,4,3,3,4,3,3,3,5
5,0,4,4,4,3,3,4,4,3,3,18,4,4,3,10,3,4,3,3,4,3,10,3,5
5,0,3,3,4,3,3,4,4,3,10,10,10,4,3,10,3,4,3,3,4,3,10,3,5
5,0,4,4,4,3,3,4,4,4,4,4,4,4,3,10,3,4,3,3,4,3,10,3,5
5,0,4,3,3,3,3,4,10,3,3,3,3,21,3,3,3,4,3,3,4,3,10,3,5
5,0,4,3,4,4,4,4,18,3,3,3,3,4,3,3,3,4,3,3,4,3,10,3,5
5,0,3,3,3,3,18,4,18,3,3,3,3,4,3,3,3,4,10,10,4,3,10,7,5
5,5,5,5,5,5,5,5,5,5,5,5,5,5,5,5,5,5,5,5,5,5,5,5,5