False
15
0
24,60
5,5,5,5,5,5,5,5,5,5,5,5,5,5,5,5,5,5,5,5,5,5,5,5,5,5,5,5,5,5,5,5,5,5,5,5,5,5,5,5,5,5,5,5,5,5,5,5,5,5,5,5,5,5,5,5,5,5,5,5
5,10,0,0,0,0,0,0,0,0,0,0,10,10,10,4,18,4,10,10,10,10,10,10,3,3,3,3,3,3,3,3,3,3,3,3,3,3,3,3,3,3,3,3,3,3,3,3,3,3,3,3,3,3,3,3,3,3,3,5
5,10,1,5,0,4,4,4,4,0,0,10,10,10,10,4,18,4,10,10,10,10,10,10,4,4,4,4,4,4,4,4,4,4,4,4,4,4,4,4,4,4,4,4,4,4,10,10,10,10,10,10,10,10,10,10,10,10,3,5
5,4,0,5,0,4,3,18,3,4,0,3,3,3,3,10,3,4,10,10,10,10,10,10,4,10,10,10,10,10,10,10,10,4,10,10,10,10,10,4,10,10,10,10,4,4,10,10,10,10,10,10,10,10,10,10,10,10,3,5
5,4,0,5,0,4,0,3,0,4,4,4,0,0,0,4,0,4,10,10,10,10,10,10,4,10,10,10,10,4,10,10,10,10,10,4,10,4,10,10,10,4,10,4,4,4,10,10,10,10,10,10,10,10,10,10,10,10,3,5
5,0,0,5,0,4,0,3,0,4,0,0,4,0,0,4,0,4,10,10,10,10,10,10,4,4,10,10,4,10,10,4,10,10,4,10,10,4,10,10,4,10,10,4,4,4,10,10,10,18,10,10,10,10,10,10,10,10,3,5
5,0,4,5,0,4,0,0,0,4,0,0,0,0,0,4,0,4,10,10,10,10,10,10,4,10,10,4,10,4,10,10,4,10,10,4,10,10,4,10,10,4,10,10,4,4,10,10,10,10,10,10,10,10,10,10,10,10,3,5
5,0,0,5,0,4,3,18,3,4,0,0,0,0,4,4,0,4,10,10,10,10,10,10,4,10,10,10,10,10,10,10,10,10,10,10,10,10,10,10,3,10,10,4,4,4,10,10,10,10,10,10,10,10,10,10,10,10,3,5
5,4,0,5,0,4,3,3,3,4,0,0,0,4,0,4,0,4,10,10,10,10,10,10,4,10,4,10,4,10,4,10,4,10,4,10,4,10,4,10,4,10,4,4,4,4,10,10,10,10,10,10,10,10,10,10,10,10,3,5
5,0,0,5,0,4,3,0,3,4,0,0,4,0,0,4,0,4,3,3,3,3,3,3,4,10,10,10,10,10,10,10,10,10,10,10,10,10,10,10,10,10,10,4,4,4,3,3,3,3,3,3,3,3,3,3,3,3,3,5
5,0,4,5,0,4,3,18,3,4,0,4,0,0,0,4,0,4,0,0,0,0,0,0,4,3,3,3,3,3,3,3,3,3,3,4,3,3,3,3,3,3,3,3,0,4,0,0,0,0,0,0,0,0,0,0,0,0,0,5
5,0,0,5,0,4,0,3,0,4,0,0,0,0,0,4,0,4,0,0,0,0,0,4,4,0,0,0,0,0,0,0,0,4,0,4,0,4,0,0,0,4,4,4,0,4,0,0,0,0,0,0,0,0,0,0,0,0,0,5
5,4,0,5,0,4,0,3,0,4,4,0,0,0,0,4,0,4,0,0,0,0,0,7,4,0,4,0,4,0,0,0,4,4,0,4,0,4,0,4,0,4,18,4,0,4,0,0,0,0,0,0,0,0,0,0,0,0,0,5
5,0,0,5,0,4,0,3,0,0,0,4,0,0,0,4,0,4,0,0,0,0,0,0,4,0,0,0,0,0,4,0,0,4,0,4,0,4,0,0,0,0,3,4,0,4,0,0,0,0,0,0,0,0,0,0,0,0,0,5
5,0,4,5,0,4,18,3,18,4,0,0,4,0,0,4,0,4,0,0,0,0,0,0,4,0,0,0,0,0,0,0,0,4,0,4,0,4,0,0,0,0,0,4,0,4,0,0,0,0,0,0,0,0,0,0,0,0,0,5
5,0,0,5,0,4,3,3,3,4,0,0,0,4,0,4,0,4,0,0,0,0,0,0,4,0,4,0,4,0,0,4,0,4,0,4,0,4,0,4,0,0,4,4,0,4,0,0,0,0,0,0,0,0,0,0,0,0,0,5
5,4,0,5,0,4,3,0,3,4,0,0,0,0,0,4,0,4,0,0,0,0,5,0,4,0,0,0,4,0,0,0,4,4,0,4,0,4,0,0,0,0,0,4,0,4,0,0,0,0,0,0,0,0,0,0,0,0,0,5
5,0,0,5,0,4,3,0,3,4,0,0,0,0,10,4,0,4,0,0,0,0,0,0,4,4,0,0,4,0,0,0,0,4,0,4,0,4,4,0,0,4,0,4,0,4,0,0,0,0,0,0,0,0,0,0,0,0,0,5
5,0,4,5,0,4,18,0,18,4,0,0,0,4,18,4,0,4,0,0,0,5,0,0,4,0,0,0,4,0,4,0,0,4,0,4,0,4,18,10,0,0,0,4,0,4,0,0,0,0,0,0,0,0,0,0,0,0,0,5
5,0,0,5,0,4,3,0,3,4,0,0,4,3,3,4,0,4,0,0,0,0,0,0,4,0,0,4,0,0,0,4,0,4,0,4,0,4,3,3,4,0,0,4,0,4,0,0,0,0,0,0,0,0,0,0,0,0,0,5
5,4,0,5,0,4,0,3,0,4,0,4,0,0,0,4,0,4,0,0,5,0,0,0,4,0,0,0,4,0,4,0,0,4,0,4,0,4,0,4,0,0,4,4,0,4,0,0,0,0,0,0,0,0,0,0,0,0,0,5
5,0,0,0,0,4,3,0,3,4,0,0,0,0,0,4,0,4,0,0,0,0,0,0,4,0,4,0,4,0,0,0,4,4,0,4,0,4,0,0,0,0,0,4,0,4,0,0,0,0,0,0,0,0,0,0,0,0,0,5
5,18,4,5,3,5,0,18,0,4,0,0,0,0,0,4,0,0,0,0,0,0,0,0,10,3,0,0,0,4,0,0,0,4,0,0,0,4,0,0,0,0,0,4,0,0,0,0,0,0,0,0,0,0,0,0,0,0,0,5
5,5,5,5,5,5,5,5,5,5,5,5,5,5,5,5,5,5,5,5,5,5,5,5,5,5,5,5,5,5,5,5,5,5,5,5,5,5,5,5,5,5,5,5,5,5,5,5,5,5,5,5,5,5,5,5,5,5,5,5