multiplayer=False
required_score=10
time=100
size_y=27
size_x=40
map_file_version=2
mapstart:
5,5,5,5,5,5,5,5,5,5,5,5,5,5,5,5,5,5,5,5,5,5,5,5,5,5,5,5,5,5,5,5,5,5,5,5,5,5,5,5
5,3,3,3,3,3,3,3,3,3,3,3,3,3,3,3,3,3,3,3,10,3,3,3,3,3,3,3,3,3,3,3,3,3,3,3,3,3,3,5
5,3,3,4,4,4,4,4,4,4,4,4,4,4,4,4,4,4,4,3,4,4,4,4,4,4,4,4,4,4,4,4,4,4,4,4,4,4,3,5
5,3,3,4,10,10,3,3,3,3,4,3,10,3,3,3,3,10,4,3,3,3,3,4,3,10,3,10,3,3,3,3,3,3,3,3,10,4,3,5
5,3,3,4,3,3,3,4,10,4,4,3,10,3,3,10,10,3,4,0,3,0,3,4,3,10,3,10,3,3,10,10,10,10,3,3,3,4,3,5
5,3,3,4,3,3,10,4,18,10,3,3,10,3,3,10,3,10,4,0,3,3,3,4,10,3,10,3,3,18,3,3,3,3,10,3,3,4,3,5
5,3,3,4,3,3,3,4,3,10,10,3,10,3,10,3,10,3,4,0,3,3,3,4,10,3,10,10,18,10,18,3,3,10,3,3,3,4,3,5
5,3,3,4,10,3,3,4,3,3,3,3,10,10,10,10,3,0,4,0,3,0,3,4,3,3,10,10,18,10,10,3,10,3,3,3,3,4,3,5
5,3,3,4,3,3,3,4,4,4,4,4,4,4,4,4,4,20,4,0,3,3,3,21,0,3,3,3,3,3,3,10,3,3,3,3,0,4,3,5
5,3,3,4,3,3,3,26,3,3,0,3,3,3,3,0,3,3,3,0,3,3,3,4,4,4,4,4,4,4,4,4,4,4,4,4,22,4,18,5
5,3,3,4,3,4,4,4,3,3,3,3,3,3,3,3,3,3,3,0,0,3,3,3,3,3,3,3,3,3,3,3,23,10,10,10,10,4,4,5
5,3,3,4,3,3,3,4,0,3,3,3,3,3,3,3,0,3,3,3,3,3,3,3,3,0,0,0,3,3,3,0,4,10,10,10,10,4,24,5
5,3,3,4,3,3,3,4,3,3,0,3,3,0,3,0,3,0,3,0,3,0,3,0,3,3,0,3,3,3,3,3,4,10,10,10,10,4,18,5
5,3,3,4,3,3,3,4,3,3,3,3,0,3,0,3,3,3,3,0,0,3,3,3,3,3,0,3,0,0,3,0,4,10,10,10,10,4,3,5
5,3,3,4,3,3,3,4,3,3,3,0,3,0,0,3,3,3,3,0,3,3,3,0,3,0,0,0,3,3,3,3,4,10,10,10,10,4,3,5
5,3,3,4,3,3,3,4,3,0,3,3,3,3,3,3,3,0,3,0,0,0,3,3,3,3,3,3,3,3,0,3,4,10,10,10,10,4,3,5
5,3,3,4,3,3,3,4,3,3,3,3,0,3,3,0,3,3,3,0,0,0,3,0,3,0,3,3,3,3,3,3,4,10,10,10,3,4,3,5
5,3,3,4,3,3,3,4,4,4,4,4,4,4,4,4,4,20,4,0,0,0,3,3,3,3,3,3,0,3,3,3,23,3,3,3,0,4,3,5
5,3,3,4,3,3,3,3,3,3,3,3,7,3,3,3,3,3,4,0,0,0,4,22,4,4,4,4,4,4,4,4,4,4,4,4,20,4,3,5
5,3,3,4,3,3,3,3,3,3,3,3,3,3,3,3,3,3,4,0,0,0,4,0,3,3,3,3,3,3,3,3,3,10,10,10,10,4,3,5
5,3,3,4,3,3,3,3,3,3,3,3,3,3,3,3,3,3,4,0,0,0,4,3,10,10,3,3,3,3,3,3,3,10,10,10,3,4,3,5
5,3,3,4,3,3,3,3,3,3,3,3,3,3,3,3,3,3,4,0,0,0,4,3,10,3,10,3,10,3,10,3,10,10,10,3,3,4,3,5
5,3,18,4,3,3,3,3,3,3,3,3,3,3,3,14,14,14,4,0,0,0,4,3,10,3,10,10,18,10,10,3,3,3,3,3,3,4,3,5
5,3,10,4,3,3,3,3,3,3,3,3,3,3,3,14,14,25,4,0,0,0,4,3,18,3,10,3,10,3,10,3,3,3,3,3,4,4,3,5
5,3,3,4,4,4,4,4,4,4,4,4,4,4,4,4,4,4,4,0,4,4,4,4,4,4,4,4,4,4,4,4,4,4,4,4,4,4,3,5
5,10,3,3,3,3,3,3,3,3,3,3,3,10,3,1,3,3,3,3,3,3,3,3,3,3,3,3,3,3,3,3,3,3,3,3,3,27,0,5
5,5,5,5,5,5,5,5,5,5,5,5,5,5,5,5,5,5,5,5,5,5,5,5,5,5,5,5,5,5,5,5,5,5,5,5,5,5,5,5