multiplayer=False
required_score=19
time=0
size_y=30
size_x=40
map_file_version=2
mapstart:
5,5,5,5,5,5,5,5,5,5,5,5,5,5,5,5,5,5,5,5,5,5,5,5,5,5,5,5,5,5,5,5,5,5,5,5,5,5,5,5
5,0,8,0,0,0,0,0,0,0,0,0,0,0,0,0,0,0,0,0,0,0,0,0,0,0,0,0,4,18,3,3,3,3,3,3,3,3,3,5
5,4,0,4,0,0,0,0,0,0,0,0,0,0,0,0,0,0,0,0,0,0,0,0,0,0,0,0,4,10,3,10,3,10,10,10,10,10,10,5
5,0,0,0,0,0,0,0,0,0,0,0,0,0,0,0,0,0,0,0,0,0,0,0,0,0,0,0,4,10,3,3,3,10,3,3,3,3,3,5
5,0,0,0,0,0,0,0,0,0,0,0,0,0,0,0,0,0,0,0,0,0,0,0,0,0,0,0,4,3,10,10,10,10,10,10,10,10,3,5
5,0,0,0,0,0,8,0,8,0,0,0,0,0,0,0,0,0,0,0,0,0,0,0,0,0,0,0,4,3,3,3,3,3,3,3,3,3,3,5
5,4,0,4,0,4,4,4,4,4,3,4,4,4,4,4,4,4,4,4,4,4,4,4,4,4,4,3,4,3,10,10,10,10,10,10,10,10,3,5
5,0,0,0,0,0,0,0,0,4,0,0,0,0,0,0,0,0,0,0,0,0,0,0,0,0,0,0,4,3,3,3,3,3,3,3,3,10,7,5
5,0,0,0,0,0,0,0,0,4,0,0,0,0,0,0,0,0,0,0,0,0,0,0,0,0,0,3,4,4,4,4,4,4,4,4,4,4,4,5
5,0,0,0,0,0,0,0,0,4,0,0,0,0,0,0,0,0,0,0,0,0,0,0,0,0,0,0,0,0,0,0,0,0,0,0,0,4,14,5
5,5,0,5,5,5,5,5,5,5,0,0,0,0,0,0,0,0,0,0,0,0,0,0,0,0,0,0,0,0,0,0,0,0,0,0,0,0,0,5
5,0,0,3,10,10,4,3,3,4,0,0,0,0,0,0,0,0,0,0,0,0,0,0,0,0,0,0,0,0,0,0,0,0,0,0,0,0,0,5
5,0,0,3,3,3,3,3,18,4,0,0,0,0,0,0,0,0,0,0,0,0,0,0,0,0,0,0,0,0,0,0,0,0,0,0,0,0,0,5
5,0,0,3,3,10,4,3,3,4,0,0,0,0,0,0,0,0,0,0,0,0,0,0,0,0,0,0,0,0,0,0,0,0,0,0,0,0,0,5
5,5,0,5,5,5,5,5,5,5,0,0,0,0,0,0,0,0,0,0,0,0,0,0,0,0,0,0,0,0,0,0,0,0,0,0,0,0,0,5
5,0,0,0,0,0,0,0,0,0,0,0,0,0,0,0,0,0,0,0,0,0,0,0,0,0,0,0,0,0,0,0,0,0,0,0,0,0,0,5
5,0,0,0,0,0,0,0,0,0,0,0,0,0,0,0,0,0,0,0,0,0,0,0,0,0,0,0,0,0,0,0,0,0,0,0,0,0,0,5
5,4,0,4,4,4,26,4,4,0,0,0,0,0,0,0,0,0,10,0,0,0,0,0,0,0,0,0,0,0,0,0,0,0,0,0,0,0,0,5
5,0,0,0,4,0,0,0,4,0,0,0,0,0,0,0,4,4,4,4,4,4,4,4,4,4,4,4,4,3,3,3,4,4,4,4,4,4,0,5
5,0,0,0,4,0,0,18,4,0,0,0,0,0,0,0,4,3,3,3,3,3,3,3,10,10,18,10,4,0,0,0,4,3,3,3,3,4,0,5
5,4,0,4,4,4,4,4,4,0,0,0,0,0,0,0,4,3,10,3,10,10,10,10,10,10,18,10,4,0,0,0,4,3,3,3,18,4,0,5
5,0,0,0,0,0,0,0,4,0,0,0,0,0,0,0,4,3,3,10,10,10,10,10,10,10,18,10,4,0,0,0,4,3,10,3,3,4,0,5
5,0,0,0,0,0,0,0,4,0,0,0,0,0,0,0,4,10,3,10,10,10,10,10,10,10,18,10,4,0,0,0,4,3,3,10,10,4,0,5
5,0,0,0,0,0,0,0,4,0,0,0,0,0,0,0,4,3,3,10,10,10,10,10,10,18,18,3,4,0,0,0,4,10,10,10,10,4,0,5
5,0,0,0,0,0,0,0,4,0,0,0,0,0,0,0,4,10,3,3,3,3,3,3,3,18,18,3,4,0,0,0,4,10,10,10,10,4,0,5
5,4,4,4,0,0,0,0,4,0,0,0,0,0,0,0,4,3,3,10,10,10,10,10,10,10,3,10,4,0,0,0,4,3,3,3,3,4,0,5
5,4,1,4,0,0,0,0,4,0,0,0,0,0,0,0,4,18,3,3,18,18,18,18,18,18,3,3,4,0,0,0,21,0,0,0,24,4,0,5
5,4,4,4,0,0,0,0,4,0,0,0,0,0,0,0,4,4,4,4,4,4,4,4,4,4,4,4,4,0,0,0,4,4,4,4,4,4,0,5
5,0,0,0,0,0,0,0,4,0,0,0,0,0,0,0,0,0,0,0,0,0,0,0,0,0,0,0,0,0,0,0,0,0,0,0,0,3,0,5
5,5,5,5,5,5,5,5,5,5,5,5,5,5,5,5,5,5,5,5,5,5,5,5,5,5,5,5,5,5,5,5,5,5,5,5,5,5,5,5