False
7
40
30,50
5,5,5,5,5,5,5,5,5,5,5,5,5,5,5,5,5,5,5,5,5,5,5,5,5,5,5,5,5,5,5,5,5,5,5,5,5,5,5,5,5,5,5,5,5,5,5,5,5,5
5,0,3,3,3,3,3,3,3,3,3,3,3,3,3,3,3,3,3,3,0,4,3,3,3,3,3,3,3,3,3,3,3,3,3,3,3,3,3,3,3,3,3,3,3,3,3,3,3,5
5,0,4,4,4,4,4,4,4,4,4,4,4,4,4,4,4,4,4,4,0,4,3,3,3,3,3,10,3,3,10,3,3,3,3,3,3,3,3,3,3,3,3,3,3,3,3,10,3,5
5,0,0,0,0,4,3,10,3,3,3,3,3,3,3,3,3,3,3,4,0,4,10,3,3,10,3,3,3,3,3,3,3,10,3,3,10,3,3,3,3,3,10,3,10,3,3,3,3,5
5,0,0,0,0,4,4,4,3,3,3,10,10,3,3,10,3,3,3,4,0,4,3,3,10,3,3,10,3,3,3,3,3,3,3,3,3,3,3,3,10,3,3,10,3,10,3,3,3,5
5,0,0,0,0,4,14,4,3,10,3,3,10,3,3,3,3,10,3,4,0,4,4,4,4,4,4,4,4,4,4,3,3,3,10,3,3,3,3,3,3,3,3,3,3,3,3,3,3,5
5,0,0,0,0,4,0,4,3,10,3,3,3,3,3,10,3,3,10,4,0,3,3,3,3,3,3,3,3,18,4,3,10,10,3,10,3,3,10,3,3,3,10,3,3,10,3,10,3,5
5,0,0,0,0,4,0,4,3,3,3,3,10,3,3,10,10,3,10,4,0,4,4,4,4,4,4,4,4,4,4,3,3,3,3,3,3,3,3,3,3,10,3,3,3,3,3,3,3,5
5,0,0,0,0,4,0,4,3,3,10,10,3,10,3,3,10,3,3,4,0,4,3,10,3,3,3,3,10,3,3,3,3,3,10,3,10,3,3,3,3,3,3,10,3,10,3,3,3,5
5,0,0,0,0,4,1,4,4,3,3,3,10,3,3,3,10,3,3,4,0,4,3,3,10,3,3,3,10,3,10,3,10,10,3,3,3,10,10,3,10,3,3,3,3,10,3,3,3,5
5,0,0,0,0,4,0,4,4,3,3,10,3,3,3,3,3,3,3,4,0,4,3,3,3,3,3,10,10,3,3,3,3,3,3,10,3,3,3,3,10,3,3,10,3,3,3,3,3,5
5,0,0,0,0,4,0,4,4,10,10,3,3,3,3,10,10,3,10,4,0,4,3,10,10,3,3,3,3,3,10,3,10,3,10,3,3,3,3,10,3,3,3,3,3,3,3,3,3,5
5,0,0,0,0,4,0,4,4,3,3,3,3,3,10,3,3,3,10,4,0,4,10,10,10,10,10,10,3,3,3,3,3,3,3,3,10,3,3,3,3,3,3,3,3,10,3,10,3,5
5,0,0,0,0,4,0,4,3,3,3,4,4,4,4,4,4,4,4,4,0,4,4,4,4,4,4,4,4,4,4,4,4,4,4,4,4,4,4,4,4,4,3,3,10,3,18,3,3,5
5,0,0,0,0,4,0,4,3,10,3,4,7,0,0,0,0,0,23,0,0,0,0,0,0,0,0,0,0,0,0,0,0,0,0,0,0,0,0,0,0,4,3,3,3,3,10,3,3,5
5,0,0,0,0,4,14,4,3,3,3,4,4,4,4,4,4,4,4,4,4,4,4,4,4,4,4,4,4,4,4,4,4,4,4,4,4,4,4,4,3,4,3,3,3,3,3,3,3,5
5,0,0,0,0,4,0,4,10,10,3,3,3,3,3,3,3,3,3,10,3,3,3,3,3,3,3,3,3,10,3,3,3,10,3,3,10,10,3,4,3,4,3,3,3,3,3,10,3,5
5,0,0,0,0,4,0,4,3,3,10,3,10,3,3,10,10,3,3,3,3,3,3,3,10,3,3,3,3,3,3,3,3,3,3,3,3,3,3,4,3,4,4,4,4,3,10,3,3,5
5,0,0,0,0,4,0,4,10,3,3,3,10,3,3,3,3,3,3,10,3,3,10,3,3,10,3,3,3,3,10,3,10,3,3,3,10,3,10,4,3,18,18,18,4,3,3,3,10,5
5,0,0,0,0,4,0,4,10,10,10,3,3,3,10,3,10,10,3,3,10,3,3,3,3,3,3,3,3,3,3,3,3,10,3,3,10,3,3,4,3,4,4,4,4,3,3,10,3,5
5,0,0,0,0,4,0,4,3,3,3,3,3,10,3,3,3,3,10,3,3,3,3,3,10,3,3,3,10,3,3,3,10,3,3,3,3,3,3,4,3,4,3,3,3,10,3,18,3,5
5,0,0,0,0,4,0,4,3,10,10,3,10,10,3,10,3,3,3,10,3,3,10,3,3,10,18,18,3,10,10,3,3,10,3,10,10,3,10,4,3,4,4,4,4,10,3,3,10,5
5,0,0,0,0,4,0,4,3,3,10,3,3,10,3,10,10,3,3,3,10,3,10,3,10,10,10,10,10,10,3,3,3,3,3,3,3,3,3,4,3,4,3,3,4,4,4,3,3,5
5,0,0,0,0,4,0,4,3,10,3,3,3,3,3,3,3,3,3,3,3,3,3,3,10,10,10,10,10,10,10,3,10,3,3,3,3,10,3,4,3,4,18,3,4,18,4,10,10,5
5,0,0,0,0,4,0,4,4,4,4,4,4,4,4,4,4,4,4,4,4,4,4,4,4,4,4,4,4,4,4,10,3,3,10,3,3,3,3,4,3,4,4,3,4,3,4,4,3,5
5,0,0,0,0,4,0,0,0,0,0,0,0,0,0,0,0,0,0,0,0,0,0,0,0,0,0,0,0,0,4,3,3,3,3,3,10,3,3,4,3,10,0,0,0,0,0,4,3,5
5,0,4,4,4,4,4,4,4,4,4,4,4,4,4,4,4,4,4,4,22,4,4,4,4,4,4,4,4,4,4,3,3,10,3,3,10,3,3,4,4,4,4,4,4,4,4,4,3,5
5,0,0,4,3,14,0,0,0,0,0,0,0,0,0,0,0,0,0,0,0,0,0,0,0,0,0,0,0,4,4,3,10,10,10,3,10,3,10,3,3,3,3,3,3,3,3,3,3,5
5,18,0,0,0,4,4,4,4,4,4,4,4,4,4,4,4,4,4,4,4,4,4,4,4,4,4,4,4,4,4,3,10,3,3,10,3,3,3,3,10,3,3,3,10,10,3,3,10,5
5,5,5,5,5,5,5,5,5,5,5,5,5,5,5,5,5,5,5,5,5,5,5,5,5,5,5,5,5,5,5,5,5,5,5,5,5,5,5,5,5,5,5,5,5,5,5,5,5,5