multiplayer=False
required_score=5
time=0
size_y=30
size_x=50
map_file_version=2
mapstart:
5,5,5,5,5,5,5,5,5,5,5,5,5,5,5,5,5,5,5,5,5,5,5,5,5,5,5,5,5,5,5,5,5,5,5,5,5,5,5,5,5,5,5,5,5,5,5,5,5,5
5,3,3,3,3,3,3,3,10,4,3,3,3,3,3,3,3,3,4,4,4,4,4,4,4,4,4,4,4,3,3,3,3,3,3,4,4,0,0,0,0,0,0,3,0,0,0,14,14,5
5,3,10,10,3,3,10,10,10,4,3,4,4,4,4,4,4,3,4,4,3,0,0,0,0,0,10,3,4,3,3,3,3,3,3,4,4,0,4,4,4,4,4,3,4,4,4,4,4,5
5,10,3,4,4,4,4,4,4,4,3,18,0,0,14,0,4,3,0,4,3,4,0,4,4,4,4,0,4,3,3,3,3,3,3,4,4,0,4,3,3,3,4,3,4,14,14,14,14,5
5,3,3,4,18,10,10,10,10,4,3,5,0,14,0,0,4,3,0,4,3,4,4,4,4,4,4,0,4,3,3,3,3,3,3,3,4,0,4,3,10,3,4,3,4,0,4,14,4,5
5,3,10,4,3,10,10,10,10,4,3,4,14,0,14,0,4,3,0,4,3,4,10,10,10,10,4,0,4,3,3,3,3,3,3,3,4,0,4,3,3,3,4,3,4,0,4,14,4,5
5,10,10,4,0,4,4,4,4,4,3,4,0,0,0,14,4,3,0,4,3,4,10,10,10,10,4,0,4,3,3,3,3,3,3,3,4,0,4,3,3,3,4,3,4,0,4,14,4,5
5,3,10,4,0,0,0,0,0,0,0,4,0,0,0,0,4,3,0,4,3,4,10,10,10,10,4,0,4,3,3,3,3,3,3,3,4,0,4,3,3,3,4,3,4,0,4,14,4,5
5,3,3,4,4,4,4,4,4,4,0,4,3,3,3,3,4,3,4,4,3,4,3,3,3,4,4,0,4,4,4,4,4,4,4,4,4,0,4,3,10,3,4,3,4,1,4,14,4,5
5,10,3,3,3,3,3,10,3,4,0,4,3,3,3,3,4,3,3,3,3,4,3,10,3,4,4,0,0,0,0,0,0,0,0,18,4,0,4,10,3,3,4,3,4,0,4,4,4,5
5,3,3,10,3,3,3,10,3,4,0,4,3,3,3,3,4,3,3,3,3,4,3,10,3,4,4,0,4,4,4,4,4,4,4,4,4,0,4,3,3,10,4,3,3,3,4,4,4,5
5,3,10,3,3,3,10,3,3,4,0,4,4,4,4,4,4,4,4,4,4,4,3,3,10,4,0,0,0,0,0,0,0,0,0,0,10,0,4,3,3,3,4,4,4,4,4,4,4,5
5,10,3,3,3,10,3,3,3,4,0,10,10,10,10,10,10,4,3,3,3,3,3,3,3,4,4,4,4,4,4,4,4,4,4,4,4,4,4,3,3,10,3,3,3,3,10,3,10,5
5,3,3,10,3,3,10,3,3,4,3,10,10,10,10,10,10,4,3,3,10,3,3,10,3,3,3,3,3,3,3,3,3,3,3,3,3,3,3,3,10,3,3,3,3,3,10,10,3,5
5,3,10,3,3,3,3,3,3,4,3,10,10,10,10,10,10,4,3,3,3,3,10,3,3,3,3,3,3,3,3,10,3,3,3,3,3,10,3,3,3,3,3,3,10,10,3,3,3,5
5,3,3,3,10,3,3,3,3,4,0,4,4,4,4,4,4,4,3,3,10,3,3,3,3,10,3,3,3,10,3,3,3,3,3,3,3,3,3,3,3,3,3,3,3,3,3,18,3,5
5,10,3,3,3,3,10,3,3,4,0,4,3,10,3,3,3,3,3,10,3,3,3,3,3,3,10,10,3,3,3,3,3,3,3,3,3,3,3,3,3,3,10,3,10,3,3,3,3,5
5,3,10,3,3,3,3,3,10,4,0,4,3,3,3,10,10,3,3,3,3,10,10,3,3,3,3,10,3,10,3,3,3,10,3,3,3,10,3,3,10,3,3,3,3,3,3,3,3,5
5,3,3,3,3,10,3,3,3,4,0,4,3,10,10,3,3,3,10,10,3,3,3,3,3,10,3,3,3,3,3,3,3,3,18,10,3,10,3,3,3,3,3,3,3,3,3,10,3,5
5,18,18,3,10,10,10,3,3,4,0,4,3,3,3,3,3,3,3,3,3,3,3,3,3,3,3,10,3,10,3,3,3,3,10,3,3,3,3,3,3,3,3,3,3,3,3,3,3,5
5,4,4,4,4,4,4,4,4,4,0,4,4,4,4,4,4,4,4,4,4,4,4,4,4,3,3,3,3,3,3,3,3,3,3,3,3,3,3,18,3,3,3,3,3,10,3,3,3,5
5,14,14,24,3,3,3,3,0,0,0,0,0,0,0,0,0,0,0,0,0,0,0,0,5,3,3,3,3,10,3,3,3,10,3,3,10,3,3,3,3,3,10,3,10,3,3,3,3,5
5,4,4,4,4,4,4,4,4,4,0,4,4,4,4,4,4,4,4,4,4,5,3,5,5,3,3,10,3,3,3,3,3,10,3,3,3,3,3,10,3,3,3,3,3,3,3,3,3,5
5,3,3,3,3,3,3,3,10,4,0,4,0,14,0,18,3,3,3,3,4,5,3,5,5,3,3,3,3,3,3,3,3,3,3,3,3,3,3,3,3,3,3,3,3,3,3,3,3,5
5,3,3,3,3,3,3,10,10,4,0,4,0,14,0,5,5,5,5,3,4,5,3,5,5,4,4,4,4,4,4,4,4,4,4,4,4,4,4,4,4,4,4,4,4,4,3,3,10,5
5,3,3,3,3,3,10,10,10,4,0,4,3,3,4,4,4,4,4,3,4,5,3,5,5,3,3,3,3,3,3,3,3,3,3,3,3,3,3,3,3,26,0,0,7,4,3,3,3,5
5,3,3,3,3,3,10,10,10,4,0,4,3,3,14,18,3,3,3,0,0,5,3,5,5,3,4,4,14,4,0,4,14,4,0,4,14,4,4,4,4,4,4,4,4,4,3,3,3,5
5,3,3,3,3,3,10,10,10,4,0,4,4,4,4,4,4,4,4,0,0,0,0,0,0,3,4,4,0,4,0,4,0,4,14,4,0,4,3,3,3,3,10,3,10,3,3,3,10,5
5,3,8,8,8,8,10,10,10,4,4,4,4,4,4,4,4,4,4,4,4,5,5,5,5,5,5,4,0,4,14,4,0,4,0,4,0,4,3,3,10,3,3,10,3,3,3,10,3,5
5,5,5,5,5,5,5,5,5,5,5,5,5,5,5,5,5,5,5,5,5,5,5,5,5,5,5,5,5,5,5,5,5,5,5,5,5,5,5,5,5,5,5,5,5,5,5,5,5,5