False
23
0
23,25
5,5,5,5,5,5,5,5,5,5,5,5,5,5,5,5,5,5,5,5,5,5,5,5,5
5,3,10,3,3,3,3,3,3,3,3,3,3,3,3,3,3,3,3,3,10,3,3,3,5
5,3,3,3,3,3,3,3,8,3,3,3,3,3,3,3,3,3,3,3,3,3,18,14,5
5,5,8,5,3,3,5,5,5,5,5,5,5,5,20,5,5,3,3,4,4,4,4,4,5
5,5,3,5,3,3,5,0,0,0,0,0,10,0,0,0,5,3,3,3,3,3,3,3,5
5,5,3,5,3,3,5,14,0,0,5,5,3,0,0,0,23,3,3,3,3,3,3,3,5
5,5,3,5,3,3,5,0,0,0,0,5,8,18,18,18,5,3,3,3,3,3,3,3,5
5,5,3,5,3,3,5,5,5,5,3,5,5,5,5,5,5,4,4,4,3,3,3,3,5
5,3,3,3,3,3,14,3,5,10,3,5,14,0,0,0,0,0,0,21,0,3,3,3,5
5,3,3,3,3,3,3,3,5,10,3,5,18,4,4,4,4,0,0,4,3,3,3,3,5
5,3,3,3,4,4,4,4,5,10,18,5,18,0,0,0,0,0,0,4,3,4,3,4,5
5,3,3,3,4,3,18,4,5,10,3,5,4,4,4,4,4,4,0,4,20,4,22,4,5
5,3,3,3,4,18,3,4,5,5,3,5,0,0,4,0,0,0,0,4,18,18,0,4,5
5,4,4,4,4,4,4,4,5,10,3,5,0,0,0,0,0,0,0,4,10,10,18,18,5
5,3,3,3,3,3,3,3,5,10,3,5,4,4,0,4,4,0,4,4,18,10,18,18,5
5,3,3,3,3,3,3,3,5,10,3,5,0,0,0,0,0,0,0,4,18,10,10,18,5
5,3,3,3,3,3,3,3,5,10,3,5,0,0,0,0,0,0,0,4,18,18,18,18,5
5,3,3,3,3,3,3,3,3,3,3,21,0,0,0,0,4,14,0,4,4,4,4,4,5
5,4,4,4,4,4,4,4,4,4,3,4,4,4,4,4,4,4,4,4,4,4,4,4,5
5,7,0,0,0,0,0,0,0,0,0,0,0,4,4,4,4,4,4,0,0,0,0,0,5
5,4,4,4,4,4,0,4,0,4,4,4,0,4,0,0,0,0,4,4,4,20,4,0,5
5,0,0,1,0,0,0,4,0,4,3,4,0,10,0,0,0,0,0,0,0,0,10,18,5
5,5,5,5,5,5,5,5,5,5,5,5,5,5,5,5,5,5,5,5,5,5,5,5,5