multiplayer=False
required_score=8
time=0
size_y=31
size_x=40
map_file_version=2
mapstart:
5,5,5,5,5,5,5,5,5,5,5,5,5,5,5,5,5,5,5,5,5,5,5,5,5,5,5,5,5,5,5,5,5,5,5,5,5,5,5,5
5,3,3,3,3,3,3,3,3,3,3,4,0,27,0,0,0,0,0,0,0,0,5,0,14,0,0,0,21,0,3,3,21,0,0,21,0,0,4,5
5,3,3,3,3,3,3,3,3,3,10,3,3,4,0,0,0,0,0,10,10,0,5,0,4,4,4,4,4,3,3,3,4,0,0,4,0,0,4,5
5,3,3,3,3,3,3,3,3,3,3,3,3,4,0,0,10,10,0,0,10,0,5,0,0,0,18,4,4,3,3,3,4,0,4,4,0,0,4,5
5,3,4,4,4,4,4,4,4,4,3,4,4,4,0,10,0,0,10,0,0,0,5,0,4,4,4,4,4,4,4,20,4,0,0,4,0,0,4,5
5,3,3,3,3,3,3,3,3,3,3,3,18,4,0,0,0,0,0,0,0,10,5,0,4,3,3,3,3,3,3,3,4,22,4,4,4,22,4,5
5,3,10,10,10,10,10,10,10,10,10,10,10,4,10,0,0,0,10,0,0,0,5,0,4,3,3,3,4,4,4,3,4,0,3,3,3,3,3,5
5,3,3,3,3,3,3,3,3,3,3,3,3,4,0,0,0,0,0,0,0,0,5,0,4,3,4,3,3,3,3,3,4,4,4,4,22,4,3,5
5,3,10,10,10,3,3,10,10,10,10,10,10,4,0,0,0,0,0,0,0,0,5,0,4,0,4,3,3,3,3,18,3,3,3,23,3,4,3,5
5,3,3,3,3,3,3,3,3,3,3,10,3,4,0,0,1,0,0,0,0,0,5,20,4,20,4,4,4,4,4,4,4,4,4,4,3,4,3,5
5,10,10,10,10,3,3,10,3,3,3,10,3,4,0,0,0,0,0,0,0,0,5,3,3,3,3,3,27,0,3,4,3,3,3,4,3,4,3,5
5,3,3,3,10,3,3,10,3,3,3,10,3,4,0,0,0,0,0,0,0,0,5,3,4,4,4,3,4,0,3,3,3,3,3,4,3,4,3,5
5,3,10,3,10,3,3,4,4,10,10,10,3,4,0,0,0,0,0,0,0,0,5,3,3,3,4,3,21,0,3,3,4,3,3,4,22,4,3,5
5,3,10,3,10,3,3,10,3,3,3,3,3,4,0,0,0,0,0,0,0,0,5,3,3,3,4,3,4,20,4,22,4,3,3,4,0,0,0,5
5,3,10,10,10,10,10,10,10,10,10,10,10,4,0,0,0,0,0,0,0,0,5,3,3,3,0,3,4,0,0,0,4,3,25,4,0,0,0,5
5,3,10,3,3,3,3,10,3,3,3,10,7,4,0,0,0,0,0,0,0,0,5,5,5,5,20,5,5,5,5,5,5,5,5,5,5,22,5,5
5,3,10,3,3,3,3,10,3,3,3,10,3,4,0,0,0,0,0,0,0,0,21,0,3,3,3,3,3,3,3,3,3,3,3,3,3,3,3,5
5,3,10,10,10,3,10,10,10,10,10,10,3,4,0,0,0,0,0,0,0,0,4,4,4,4,4,4,4,4,4,4,4,4,4,4,4,4,3,5
5,3,3,3,3,3,3,3,3,3,3,3,3,4,0,0,0,0,0,0,0,0,23,3,3,3,3,3,3,3,3,3,3,3,3,3,3,10,3,5
5,4,4,4,4,4,4,4,4,4,4,4,4,4,0,0,0,0,0,0,0,0,4,3,3,3,3,4,4,4,4,4,4,4,3,3,3,10,3,5
5,3,3,3,3,3,10,3,10,3,3,10,3,4,0,0,0,0,0,0,0,0,4,3,3,3,3,4,3,3,3,3,3,4,3,3,3,10,3,5
5,0,3,3,3,3,10,14,10,3,3,10,18,4,0,0,0,0,0,0,0,0,4,3,3,3,3,3,3,3,3,3,18,4,3,3,3,10,3,5
5,26,4,4,4,4,4,4,4,4,4,4,4,4,0,0,0,0,0,0,3,3,4,4,4,4,4,4,4,4,4,4,4,4,4,4,4,4,4,5
5,3,3,3,3,3,3,3,3,3,3,3,3,3,3,4,3,3,3,4,3,3,3,3,3,3,3,3,3,3,3,3,3,3,3,3,3,3,3,5
5,3,3,3,3,3,3,3,3,3,3,3,3,3,3,4,3,3,3,4,3,3,10,3,10,3,10,3,10,3,3,3,10,3,10,10,10,10,10,5
5,3,3,3,3,3,3,3,3,3,3,3,3,3,3,4,3,3,3,4,3,3,10,3,10,3,10,3,10,3,3,3,10,3,3,3,3,3,3,5
5,3,3,3,3,3,3,3,3,3,3,3,3,3,3,3,3,3,3,4,3,10,10,10,10,10,10,10,10,10,10,10,10,3,3,3,3,3,3,5
5,3,3,3,3,3,3,3,3,3,3,3,3,3,3,4,4,4,4,4,3,3,3,3,3,3,3,18,10,3,3,3,10,3,3,3,3,3,3,5
5,3,3,3,4,4,4,3,3,3,3,3,3,3,3,4,3,3,3,4,3,3,3,3,3,3,3,3,10,3,3,3,10,3,3,3,3,3,3,5
5,3,3,3,4,18,4,8,3,3,3,3,3,3,3,4,3,3,3,4,3,3,3,3,3,3,3,3,10,18,3,3,10,3,3,3,3,24,3,5
5,5,5,5,5,5,5,5,5,5,5,5,5,5,5,5,5,5,5,5,5,5,5,5,5,5,5,5,5,5,5,5,5,5,5,5,5,5,5,5