False
13
0
30,32
5,5,5,5,5,5,5,5,5,5,5,5,5,5,5,5,5,5,5,5,5,5,5,5,5,5,5,5,5,5,5,5
5,0,0,0,10,3,3,10,10,3,3,0,0,0,0,0,0,0,0,0,0,0,0,0,0,0,0,10,3,18,3,5
5,18,4,10,3,3,0,10,3,3,3,0,0,0,0,0,0,0,0,0,0,0,0,0,0,0,0,5,10,10,10,5
5,4,4,4,4,4,4,4,4,4,4,0,0,0,0,0,0,0,0,0,0,0,0,0,0,0,0,5,10,10,3,5
5,0,0,0,0,0,0,0,0,0,4,0,0,0,0,0,0,0,0,0,0,0,0,0,0,0,0,5,3,10,3,5
5,0,4,4,4,4,4,4,4,0,0,0,0,0,0,0,0,0,0,0,0,0,0,0,0,0,0,21,0,3,3,5
5,0,4,0,0,0,0,0,4,0,4,3,3,3,3,3,3,3,4,4,4,4,4,4,4,4,0,5,5,5,5,5
5,0,4,0,4,4,4,0,4,0,4,10,3,10,3,3,3,3,4,0,0,10,0,0,0,0,0,4,18,0,0,5
5,0,4,0,4,0,4,0,4,0,4,10,3,10,3,3,3,10,4,0,4,10,4,0,0,0,0,4,5,0,0,5
5,0,4,0,0,18,4,0,0,0,4,10,3,10,3,3,10,10,4,18,0,10,0,0,0,0,0,4,0,0,0,5
5,0,4,0,4,4,4,0,4,0,4,10,3,10,3,10,10,10,4,4,4,4,4,4,0,4,0,4,0,0,0,5
5,0,4,0,0,0,14,0,4,14,4,10,3,10,10,10,10,10,10,10,10,10,18,4,3,10,10,0,0,0,0,5
5,0,4,4,4,4,4,4,4,4,4,3,3,3,3,3,3,3,3,3,3,10,3,4,3,10,10,4,0,0,0,5
5,0,0,0,0,0,0,0,0,0,4,3,3,3,3,3,3,3,3,3,3,10,3,4,3,10,10,4,0,0,0,5
5,4,4,4,4,4,0,4,4,4,4,4,4,4,4,4,4,4,4,4,4,4,4,4,4,4,4,4,4,4,4,5
5,0,0,0,0,0,0,0,0,0,0,0,0,0,0,0,0,0,0,0,0,0,0,4,0,0,0,0,0,0,0,5
5,0,0,0,0,0,0,0,0,0,0,0,0,0,0,0,0,0,0,0,0,0,0,0,0,0,0,0,0,0,0,5
5,0,0,0,0,0,0,0,0,0,0,0,0,0,0,0,8,0,0,0,0,0,0,0,0,0,0,0,0,0,3,5
5,4,22,4,4,4,4,4,4,4,4,4,4,4,4,4,4,0,0,0,0,0,0,0,0,0,0,0,0,4,0,5
5,10,0,3,3,18,4,0,0,0,0,0,0,4,4,0,4,0,0,0,0,0,0,0,0,0,0,0,4,3,0,5
5,10,3,3,10,4,4,0,4,4,0,4,0,0,0,0,4,0,0,0,0,0,0,0,0,0,0,4,3,3,0,5
5,10,3,10,18,10,4,0,14,18,4,4,0,4,4,0,4,4,4,4,4,4,4,4,4,0,4,14,18,0,0,5
5,3,3,10,18,10,4,4,4,4,4,4,0,0,4,4,4,4,4,4,4,4,4,4,4,10,4,4,4,4,4,5
5,3,10,10,10,10,0,0,0,0,0,4,4,4,4,4,10,4,4,0,0,0,0,0,4,10,4,0,0,0,7,5
5,3,3,3,3,3,0,0,0,4,0,0,0,0,0,0,10,0,0,0,0,0,0,0,0,3,0,0,0,0,18,5
5,4,4,4,4,0,0,4,4,4,4,4,4,4,4,4,4,4,4,4,4,4,4,4,4,4,4,4,4,4,4,5
5,0,0,0,0,0,0,23,0,0,4,14,4,0,4,0,0,0,0,0,0,0,0,0,14,0,0,0,0,4,4,5
5,1,0,0,0,0,0,4,0,14,0,0,0,14,0,0,4,4,4,4,4,4,4,4,4,4,3,4,0,4,4,5
5,0,0,0,0,0,0,21,0,0,4,0,4,0,4,0,0,0,0,0,0,0,0,0,0,0,0,0,0,18,14,5
5,5,5,5,5,5,5,5,5,5,5,5,5,5,5,5,5,5,5,5,5,5,5,5,5,5,5,5,5,5,5,5