True
10
60
25,41
5,5,5,5,5,5,5,5,5,5,5,5,5,5,5,5,5,5,5,5,5,5,5,5,5,5,5,5,5,5,5,5,5,5,5,5,5,5,5,5,5
5,0,0,0,0,0,0,0,0,0,0,0,0,0,0,8,0,0,0,0,0,0,0,0,0,0,0,0,0,10,0,0,4,3,3,3,3,10,3,7,5
5,0,4,4,0,4,4,0,4,4,0,4,4,4,4,4,4,4,0,0,0,0,4,4,4,4,0,0,4,4,4,0,4,3,18,3,3,10,3,3,5
5,0,0,0,0,0,0,0,0,0,0,0,4,4,4,4,4,4,0,4,0,0,0,0,0,0,0,4,0,0,0,0,4,3,3,3,3,10,10,10,5
5,0,0,0,0,0,0,0,0,0,0,0,4,0,0,0,0,4,0,0,0,0,4,0,0,0,0,0,0,0,0,0,4,3,3,3,3,10,3,3,5
5,0,0,0,4,0,0,0,0,0,4,0,4,3,3,3,8,4,0,0,0,10,0,0,0,0,0,0,0,0,0,0,4,3,3,3,3,10,3,3,5
5,0,0,0,0,0,0,0,0,0,0,0,4,3,3,3,3,4,4,4,4,4,4,4,4,4,4,0,4,4,4,4,4,4,4,4,4,4,4,4,5
5,0,0,0,0,0,0,0,0,0,0,0,4,18,3,3,3,4,0,0,0,0,0,0,0,0,0,0,0,0,0,0,0,0,0,0,0,0,0,0,5
5,0,10,0,0,0,0,0,0,4,0,0,4,4,4,4,4,4,0,0,0,0,0,0,0,0,0,0,0,0,0,0,0,10,0,0,0,0,10,0,5
5,3,3,3,3,10,3,3,3,3,3,3,3,3,3,3,3,3,3,3,3,3,3,3,3,3,3,3,3,3,3,10,3,3,3,3,3,3,3,3,5
5,3,3,10,3,3,10,3,3,3,10,3,3,3,3,10,3,3,3,3,3,3,10,3,3,10,3,3,10,3,3,3,3,3,3,3,3,3,3,3,5
5,3,3,10,3,3,3,3,3,3,3,3,10,3,3,3,3,3,3,3,3,3,3,3,3,3,3,3,10,3,3,3,3,3,3,10,3,3,3,3,5
5,10,3,3,3,3,3,3,3,3,3,3,3,3,3,10,3,10,10,3,3,3,10,3,10,3,3,3,3,3,3,3,3,10,3,3,3,3,3,3,5
5,4,4,4,4,4,3,3,10,3,3,10,18,3,3,3,18,10,3,3,3,3,3,3,3,3,3,10,3,3,3,3,3,3,3,3,3,10,3,3,5
5,8,3,3,3,4,3,3,3,3,3,3,3,3,3,3,3,3,18,3,3,3,3,3,3,3,3,3,3,3,3,3,3,3,3,10,3,3,3,3,5
5,3,3,3,3,4,4,3,10,10,10,10,3,3,10,3,3,10,10,3,3,10,3,10,3,3,10,3,3,3,10,3,3,3,10,3,3,3,3,3,5
5,3,3,3,3,4,3,3,3,3,3,3,3,10,3,3,10,3,10,18,18,3,3,3,3,3,3,3,3,10,3,3,3,3,3,3,3,3,3,3,5
5,4,4,3,10,4,3,3,3,10,3,3,3,10,3,3,3,18,10,10,3,3,3,3,10,3,3,3,10,3,3,3,3,10,3,3,3,3,3,3,5
5,18,4,3,3,3,3,3,3,3,3,3,3,10,3,3,3,3,3,10,3,3,3,3,10,3,3,3,3,3,3,3,3,10,3,3,3,10,3,3,5
5,4,4,4,4,4,4,4,4,4,4,4,4,4,4,4,4,4,4,4,4,4,4,4,4,4,4,4,4,4,4,4,4,4,4,4,4,4,4,4,5
5,3,2,3,3,3,3,3,3,3,3,3,8,3,3,3,3,3,3,3,10,3,3,3,3,3,3,3,10,3,3,3,3,3,3,3,3,3,10,8,5
5,3,3,3,3,3,3,3,10,3,3,3,18,3,3,3,3,3,3,4,10,4,4,3,3,3,3,3,3,10,3,3,3,3,3,3,3,3,3,8,5
5,3,1,3,3,10,3,3,3,3,3,3,4,3,3,3,3,3,3,4,10,4,4,3,3,3,3,3,3,3,10,3,3,3,3,3,3,3,8,3,5
5,3,3,3,3,3,10,3,3,3,3,3,4,3,3,3,3,3,3,3,10,0,3,3,3,3,3,3,3,3,3,10,3,3,3,3,3,3,3,3,5
5,5,5,5,5,5,5,5,5,5,5,5,5,5,5,5,5,5,5,5,5,5,5,5,5,5,5,5,5,5,5,5,5,5,5,5,5,5,5,5,5