multiplayer=True
required_score=8
time=0
size_y=27
size_x=50
map_file_version=2
mapstart:
5,5,5,5,5,5,5,5,5,5,5,5,5,5,5,5,5,5,5,5,5,5,5,5,5,5,5,5,5,5,5,5,5,5,5,5,5,5,5,5,5,5,5,5,5,5,5,5,5,5
5,0,0,0,0,0,0,0,0,0,0,0,0,0,0,0,0,0,0,0,0,0,0,0,0,0,0,0,0,0,0,0,0,0,0,0,0,0,4,18,3,3,3,3,3,10,3,3,10,5
5,0,0,1,0,0,0,0,0,0,0,10,0,0,0,0,0,0,0,0,0,0,0,0,0,0,0,0,0,0,0,0,0,0,0,0,0,0,4,3,3,3,3,3,10,3,3,3,3,5
5,0,0,0,0,0,0,0,4,4,4,4,4,4,4,3,3,3,3,3,3,3,3,3,3,3,3,3,3,3,3,3,3,3,3,3,3,3,4,4,3,3,3,10,10,10,7,3,10,5
5,0,0,0,0,0,0,0,4,0,0,0,0,0,0,0,0,0,0,0,0,0,0,0,0,0,0,0,0,0,0,0,0,0,0,0,0,0,4,3,3,3,10,10,10,3,3,3,10,5
5,0,0,0,0,0,0,0,4,0,0,0,0,0,0,0,0,0,0,0,0,0,0,0,0,0,0,0,0,0,0,0,0,0,0,0,0,0,4,3,3,10,10,10,10,10,3,3,18,5
5,4,4,4,4,4,4,4,4,0,0,0,0,0,0,0,0,0,0,0,0,0,0,0,0,0,0,0,0,0,0,0,0,0,0,0,0,0,4,3,4,4,4,4,3,4,4,4,4,5
5,3,3,3,3,3,10,10,4,0,0,0,0,0,0,0,0,0,0,0,0,0,0,0,0,0,0,0,0,0,0,0,0,0,0,0,0,0,4,3,3,3,3,3,3,3,3,3,3,5
5,3,10,10,3,3,10,3,3,0,0,0,0,0,0,0,0,0,0,0,0,0,0,0,0,0,0,0,0,0,0,0,0,0,0,0,0,0,4,4,4,4,4,4,4,4,4,4,3,5
5,3,10,3,3,3,3,10,4,0,0,0,0,0,0,0,0,0,0,0,0,0,0,0,0,0,0,0,0,0,0,0,0,0,0,0,0,0,4,3,3,3,3,3,3,3,3,3,3,5
5,3,10,3,3,10,10,3,4,0,0,0,0,0,8,0,0,0,0,0,0,0,0,0,0,0,0,0,0,0,0,0,0,0,0,0,0,0,4,3,3,3,3,10,10,10,10,3,3,5
5,18,10,10,3,10,10,3,3,0,0,0,0,0,4,4,4,4,4,4,4,4,4,4,4,4,4,4,4,4,4,4,4,4,4,4,4,4,4,3,3,3,3,3,3,18,10,3,3,5
5,4,4,4,4,4,4,4,4,4,4,4,4,4,4,4,4,10,4,4,4,4,4,4,4,4,4,4,4,4,4,4,4,4,4,4,4,4,4,4,4,4,4,4,4,4,4,4,4,5
5,0,0,0,0,0,0,0,0,0,0,0,0,0,0,0,0,10,0,0,0,0,0,0,0,0,0,0,0,0,0,0,0,0,0,0,0,0,21,0,3,3,3,3,3,3,3,3,3,5
5,0,0,0,0,0,0,0,0,0,0,0,0,0,4,4,4,10,4,4,0,0,0,0,0,0,0,0,0,0,0,0,0,0,0,0,0,0,4,4,10,3,10,10,10,10,10,10,10,5
5,0,0,0,0,0,0,0,0,0,0,0,0,0,0,0,0,10,0,0,0,0,0,0,0,0,0,0,0,0,0,0,0,0,0,0,0,0,0,4,3,3,10,10,10,10,10,10,10,5
5,0,0,0,0,0,0,0,0,0,0,0,0,0,4,4,4,10,4,4,0,0,0,0,0,0,0,0,0,0,0,0,0,0,0,0,0,0,0,4,10,3,10,10,3,3,3,3,3,5
5,0,0,0,0,0,0,0,0,0,0,0,0,0,0,0,0,10,0,0,0,0,0,0,0,0,0,0,0,0,0,0,0,0,8,0,0,0,0,4,3,3,10,10,3,3,3,3,3,5
5,0,0,0,0,0,0,0,0,0,0,0,0,0,4,4,4,10,4,4,0,0,0,0,0,0,0,0,0,0,0,0,0,4,4,4,0,0,0,4,3,3,10,10,3,3,3,3,3,5
5,0,0,0,0,0,0,0,0,0,0,0,0,0,0,0,0,10,0,0,0,0,0,0,0,0,0,0,0,0,0,0,0,4,4,4,0,0,0,4,3,3,10,10,3,3,3,3,3,5
5,0,0,0,0,0,0,0,0,0,0,0,0,0,4,4,4,10,4,4,0,0,0,0,0,0,0,0,0,0,0,0,0,4,4,4,0,0,0,4,3,3,10,10,3,3,3,3,3,5
5,0,0,0,0,0,0,0,0,0,0,0,0,0,0,0,0,10,0,0,0,0,0,0,0,0,0,0,0,0,0,0,0,4,4,4,0,0,0,4,3,3,10,10,3,3,3,3,3,5
5,0,0,0,0,0,0,0,0,0,0,0,0,0,4,4,4,10,4,4,0,0,0,0,0,0,0,0,0,0,0,0,0,4,18,4,0,0,0,4,3,3,10,10,3,3,7,3,3,5
5,0,0,0,0,0,0,0,0,0,0,0,0,0,0,0,0,10,0,0,0,0,0,0,0,0,0,0,0,0,0,0,0,4,18,4,0,0,0,4,3,3,10,10,3,3,3,3,3,5
5,0,0,2,0,0,0,0,0,0,0,0,0,0,4,4,4,10,4,4,0,0,0,0,0,0,0,0,0,0,0,0,0,4,4,4,0,0,0,4,3,3,10,10,3,3,3,3,3,5
5,0,0,0,0,0,0,0,0,0,0,0,0,0,0,0,0,10,0,0,8,18,0,0,0,0,0,0,0,0,0,0,0,4,4,4,0,0,0,4,18,3,10,10,3,3,3,3,3,5
5,5,5,5,5,5,5,5,5,5,5,5,5,5,5,5,5,5,5,5,5,5,5,5,5,5,5,5,5,5,5,5,5,5,5,5,5,5,5,5,5,5,5,5,5,5,5,5,5,5