True
3
0
10,20
5,5,5,5,5,5,5,5,5,5,5,5,5,5,5,5,5,5,5,5
5,3,1,3,2,3,3,3,3,3,3,3,8,3,3,3,3,3,3,5
5,3,3,18,3,3,3,3,3,3,3,3,8,3,10,3,3,3,3,5
5,3,3,11,3,3,3,3,3,3,3,3,3,3,8,3,3,3,3,5
5,3,3,3,3,3,3,3,3,3,3,3,3,3,3,3,3,3,3,5
5,3,3,3,3,3,3,3,3,3,14,3,3,3,3,3,3,3,3,5
5,3,3,3,3,14,3,3,3,3,3,3,3,3,3,3,3,3,3,5
5,3,3,3,3,3,3,3,3,3,3,3,3,3,3,18,3,3,3,5
5,3,3,3,3,3,3,3,3,3,3,3,3,3,3,3,3,3,3,5
5,5,5,5,5,5,5,5,5,5,5,5,5,5,5,5,5,5,5,5