True
4
0
10,15
5,5,5,5,5,5,5,5,5,5,5,5,5,5,5
5,0,0,10,3,3,3,5,3,3,10,3,3,18,5
5,3,3,10,1,3,3,5,3,3,10,3,3,18,5
5,3,3,2,3,3,3,5,3,3,5,5,5,5,5
5,5,5,18,5,5,5,5,3,3,3,3,3,3,5
5,3,3,3,3,3,3,4,3,3,3,3,3,3,5
5,3,3,5,3,3,3,4,3,3,3,3,3,7,5
5,3,3,5,3,3,3,4,3,3,3,3,3,3,5
5,18,3,5,3,3,8,4,3,3,3,3,3,7,5
5,5,5,5,5,5,5,5,5,5,5,5,5,5,5