multiplayer=True
required_score=5
time=0
size_y=25
size_x=40
map_file_version=2
mapstart:
5,5,5,5,5,5,5,5,5,5,5,5,5,5,5,5,5,5,5,5,5,5,5,5,5,5,5,5,5,5,5,5,5,5,5,5,5,5,5,5
5,0,0,0,0,0,0,0,0,0,0,0,0,0,0,0,0,0,0,0,0,0,0,0,0,0,0,0,0,0,0,0,23,10,4,0,0,14,4,5
5,0,0,0,0,0,0,0,0,0,0,0,0,0,0,0,0,0,0,0,0,0,0,0,0,0,0,0,0,0,0,0,4,3,0,4,24,0,0,5
5,4,4,4,0,0,0,0,0,0,0,0,0,0,0,0,0,0,0,0,0,0,0,0,0,0,0,0,0,0,0,0,4,0,0,0,4,0,0,5
5,4,10,4,0,0,0,0,0,0,0,0,0,0,0,0,0,0,0,0,0,0,0,0,0,0,0,0,0,0,0,0,4,4,0,4,4,0,4,5
5,4,3,4,0,0,0,0,0,0,0,0,0,0,0,0,0,0,0,0,0,0,0,0,0,0,0,0,0,0,0,0,4,23,0,0,0,0,4,5
5,0,0,0,0,0,0,0,0,0,0,0,0,0,0,0,0,0,0,0,0,0,0,0,0,0,0,0,0,0,0,0,4,4,4,20,4,4,4,5
5,0,0,0,0,0,0,0,0,0,0,0,0,0,0,0,0,0,0,0,0,0,0,0,0,0,0,0,0,0,0,0,0,0,0,0,0,0,0,5
5,0,0,0,0,0,0,0,0,0,0,0,0,0,0,0,0,0,0,0,0,0,0,0,0,0,0,0,0,0,0,0,0,0,0,0,0,0,0,5
5,0,0,0,0,0,0,0,0,0,0,0,0,0,0,0,0,0,0,0,0,0,0,0,0,0,0,0,0,0,0,0,0,0,10,0,0,0,0,5
5,4,4,4,4,4,4,4,4,0,4,4,4,4,4,4,4,4,4,4,4,3,4,4,4,4,4,4,4,3,3,4,4,4,4,4,4,4,4,5
5,4,4,4,4,4,4,4,4,0,0,0,0,0,0,0,0,0,0,0,0,0,0,0,0,4,4,10,4,0,0,0,0,0,0,0,0,0,0,5
5,3,3,4,0,0,0,0,4,0,0,0,0,0,0,0,0,0,0,0,0,0,0,0,0,4,4,10,4,0,0,0,0,0,0,0,0,0,0,5
5,3,3,4,0,0,0,0,4,0,0,0,0,0,0,0,0,0,0,0,0,0,0,0,0,4,4,10,4,0,0,0,0,0,0,0,0,0,0,5
5,7,3,4,10,10,10,10,4,0,0,0,0,0,0,0,0,0,0,0,0,0,0,0,0,4,3,3,0,0,0,0,0,0,0,0,0,0,0,5
5,3,3,4,10,10,10,10,4,0,0,0,0,0,0,0,0,0,0,0,0,8,0,0,0,4,3,4,5,0,0,0,2,0,0,0,0,0,0,5
5,3,3,4,10,10,10,10,4,0,0,0,0,0,0,0,0,0,0,0,4,4,4,0,0,4,3,23,0,0,0,0,0,0,0,0,0,0,0,5
5,3,3,4,10,10,10,18,4,0,0,0,0,0,0,0,0,0,0,0,4,18,4,0,0,4,0,4,4,0,0,0,0,0,0,0,0,0,0,5
5,3,3,4,3,3,3,3,4,0,0,0,0,0,0,0,0,0,0,0,4,4,4,0,0,4,0,4,4,0,0,0,0,0,0,0,0,0,0,5
5,3,3,3,3,3,3,3,3,0,0,0,0,0,0,0,0,0,0,0,0,0,0,0,0,4,0,0,21,0,0,0,8,0,0,0,4,10,3,5
5,3,3,4,0,0,0,0,5,0,0,0,0,0,0,0,0,0,0,0,0,0,0,0,0,4,0,4,4,0,0,4,4,4,0,0,4,10,3,5
5,3,3,4,0,0,0,0,5,0,0,0,0,0,0,0,0,0,0,0,0,0,0,0,0,4,0,4,4,0,0,4,1,4,0,0,4,10,3,5
5,26,4,4,0,0,0,0,5,0,0,0,0,0,0,0,0,0,0,0,0,0,0,0,0,4,0,4,4,0,0,4,4,4,0,0,4,10,3,5
5,0,18,4,0,0,0,0,5,0,0,0,0,0,0,0,0,0,0,0,0,0,0,0,0,4,0,18,5,0,0,0,0,0,0,0,4,10,18,5
5,5,5,5,5,5,5,5,5,5,5,5,5,5,5,5,5,5,5,5,5,5,5,5,5,5,5,5,5,5,5,5,5,5,5,5,5,5,5,5