multiplayer=True
required_score=6
time=0
size_y=30
size_x=50
map_file_version=2
mapstart:
5,5,5,5,5,5,5,5,5,5,5,5,5,5,5,5,5,5,5,5,5,5,5,5,5,5,5,5,5,5,5,5,5,5,5,5,5,5,5,5,5,5,5,5,5,5,5,5,5,5
5,0,1,0,2,0,0,0,0,0,0,0,0,0,0,0,0,0,0,0,0,0,0,0,0,0,0,0,0,0,0,0,0,0,0,0,0,0,0,0,0,0,0,0,0,4,14,0,7,5
5,0,10,0,10,0,0,0,0,0,0,0,0,0,0,0,0,0,0,0,0,0,0,0,0,0,0,0,0,0,0,0,0,0,0,0,0,0,0,0,0,0,0,0,0,4,0,0,0,5
5,5,5,5,5,3,3,3,3,3,3,3,3,3,3,3,3,3,3,0,3,3,3,3,3,3,3,3,3,3,3,3,3,3,3,3,3,3,3,3,3,3,3,3,3,4,0,0,0,5
5,0,0,0,0,0,0,0,0,0,0,0,0,0,0,0,0,0,0,0,0,0,0,0,0,0,0,0,0,0,0,0,0,0,0,0,0,0,0,0,0,0,0,0,0,4,0,0,0,5
5,0,0,0,0,0,0,0,0,0,0,0,0,0,0,0,0,0,0,0,0,0,0,0,0,0,0,0,0,0,0,0,0,0,0,0,0,0,0,0,0,0,0,0,0,4,0,0,0,5
5,0,0,0,0,0,0,0,0,0,0,0,0,0,0,0,0,0,0,0,0,0,0,0,0,0,0,0,0,0,0,0,0,0,0,0,0,0,0,0,0,0,0,0,0,4,0,0,0,5
5,0,0,0,0,8,0,0,0,0,0,0,0,0,0,0,0,0,0,0,0,0,0,0,0,0,0,0,0,0,0,0,0,0,0,0,0,0,0,0,0,0,0,0,8,4,0,0,0,5
5,4,4,4,4,4,4,4,4,4,4,4,0,4,0,4,4,4,4,4,4,4,4,4,0,4,4,4,4,4,4,0,4,0,4,4,4,4,4,4,4,4,4,4,4,4,4,20,4,5
5,0,0,0,0,0,0,0,0,0,0,0,0,0,0,0,0,0,0,0,0,0,0,0,0,0,0,0,0,0,0,0,0,0,0,0,0,0,0,0,0,0,0,0,0,4,0,0,0,5
5,0,0,0,0,0,0,0,0,0,0,0,0,0,0,0,0,0,0,0,0,0,0,0,0,0,0,0,0,0,0,0,0,0,0,0,0,0,0,0,0,0,0,0,0,4,0,0,0,5
5,0,0,0,0,0,0,0,0,0,0,0,0,0,0,0,0,0,0,0,0,0,0,0,0,0,4,4,4,4,4,4,4,4,4,0,0,0,0,0,0,0,0,0,0,4,0,0,0,5
5,0,0,0,0,0,0,0,0,0,0,0,0,0,0,0,0,0,0,0,0,0,0,0,0,0,4,10,10,10,10,10,3,10,4,0,0,0,0,0,0,0,0,0,0,4,0,0,0,5
5,0,0,0,0,0,0,0,0,0,0,0,0,0,0,0,0,0,0,0,0,0,0,0,0,0,4,3,3,18,10,10,3,10,4,0,0,0,0,0,0,0,0,0,0,4,0,0,0,5
5,0,0,0,0,0,0,0,0,0,0,0,0,0,0,0,0,0,0,0,0,0,0,0,0,0,4,3,10,10,10,10,3,10,4,0,0,0,0,0,0,0,0,0,0,4,0,0,0,5
5,4,4,4,4,0,4,4,4,4,4,4,4,0,4,4,4,4,4,0,0,0,0,0,0,0,4,3,10,10,10,10,3,10,4,0,0,0,0,0,0,0,0,0,0,4,0,0,0,5
5,0,0,0,0,0,0,0,0,0,0,0,0,0,0,0,0,0,0,0,0,0,0,0,0,0,4,3,3,3,3,3,3,10,4,0,0,0,0,0,0,0,0,0,0,4,0,0,0,5
5,0,0,0,0,0,0,0,0,0,0,0,0,0,0,0,0,0,0,0,0,0,0,0,0,0,4,4,4,4,4,4,4,4,4,0,0,0,0,0,0,0,0,0,0,4,0,0,0,5
5,0,0,0,0,0,0,0,0,0,0,0,0,0,0,0,0,0,0,0,0,0,0,0,0,0,0,0,0,0,0,0,0,0,0,0,0,0,0,0,0,0,0,0,0,4,0,0,0,5
5,0,0,0,0,0,0,0,0,0,0,0,0,0,0,0,0,0,0,0,0,0,0,0,0,0,0,0,0,0,0,0,0,0,0,0,0,0,0,0,0,0,0,0,0,4,0,0,0,5
5,0,0,0,0,0,0,0,0,0,0,0,0,4,0,4,3,3,3,3,3,3,3,3,3,4,4,4,4,4,4,4,4,4,4,4,4,4,4,4,4,4,4,4,22,4,4,10,3,5
5,0,0,0,0,0,0,0,0,0,0,0,0,4,0,4,3,3,3,10,10,10,10,10,10,4,0,0,0,0,0,0,0,0,0,0,0,4,3,3,3,3,3,10,0,3,4,10,3,5
5,0,0,0,0,8,0,0,0,0,0,0,0,4,0,4,3,3,3,10,3,3,3,3,3,4,0,0,0,0,0,0,0,0,4,0,10,0,3,3,3,3,3,10,3,3,4,10,3,5
5,4,4,4,4,4,4,4,4,4,4,4,4,4,0,4,3,8,3,10,3,3,3,3,3,4,20,4,4,4,4,4,4,4,4,4,4,4,3,3,3,3,3,10,3,3,3,5,3,5
5,3,3,3,3,3,3,3,3,3,3,3,3,4,0,4,3,3,3,10,3,3,3,3,3,4,0,21,0,0,10,10,3,3,10,10,3,4,3,3,3,3,3,10,3,3,3,4,3,5
5,3,3,10,3,3,3,3,3,3,3,3,14,4,0,4,3,3,3,10,3,3,3,3,3,4,0,4,3,10,10,10,10,3,10,3,3,4,3,3,3,3,3,10,3,3,3,4,3,5
5,3,3,3,10,3,14,3,3,3,3,3,3,4,0,4,3,3,3,10,3,3,3,3,18,4,0,4,3,10,10,10,3,10,10,3,3,4,3,3,3,3,3,10,3,3,3,4,3,5
5,3,3,3,3,10,3,3,3,14,3,3,3,4,0,4,3,10,10,10,3,3,3,3,3,4,0,4,3,10,10,3,3,10,3,3,3,4,3,3,3,3,3,10,3,3,3,4,3,5
5,3,18,3,3,3,10,3,3,3,3,3,3,4,18,4,3,3,3,3,3,3,3,3,3,4,0,4,3,3,18,18,10,3,3,3,3,4,8,3,3,3,3,8,3,3,3,4,3,5
5,5,5,5,5,5,5,5,5,5,5,5,5,5,5,5,5,5,5,5,5,5,5,5,5,5,5,5,5,5,5,5,5,5,5,5,5,5,5,5,5,5,5,5,5,5,5,5,5,5