True
27
0
27,40
5,5,5,5,5,5,5,5,5,5,5,5,5,5,5,5,5,5,5,5,5,5,5,5,5,5,5,5,5,5,5,5,5,5,5,5,5,5,5,5
5,4,0,3,3,3,3,3,3,3,21,3,3,4,4,4,4,4,4,0,0,0,0,0,0,4,0,21,0,21,0,0,18,18,18,18,18,18,18,5
5,4,20,4,4,4,4,4,4,4,4,3,3,4,0,0,0,4,4,0,0,0,0,0,0,4,20,0,22,0,22,4,10,10,10,10,10,10,18,5
5,4,0,0,0,21,0,0,0,21,0,3,3,4,0,7,0,4,4,0,0,0,0,0,0,4,0,23,0,23,0,4,3,3,3,3,10,3,18,5
5,4,0,4,3,4,20,4,21,4,0,3,3,4,0,14,0,4,4,0,0,0,0,0,0,4,20,0,21,0,0,4,18,18,18,18,10,18,18,5
5,4,0,4,3,4,0,4,3,4,0,3,3,4,0,0,0,4,4,0,0,0,0,0,0,4,0,20,0,21,0,4,10,10,10,18,10,18,3,5
5,4,0,4,3,4,0,4,3,4,0,3,3,4,4,20,4,4,4,0,0,0,0,0,0,4,23,0,21,0,22,4,10,10,10,18,18,18,3,5
5,4,0,4,3,4,20,4,3,4,0,3,3,3,3,3,3,3,4,0,0,0,0,0,0,4,0,20,0,21,0,4,10,10,10,10,10,3,10,5
5,4,0,4,3,3,18,21,0,4,0,3,3,3,3,3,3,3,4,0,0,0,0,0,0,4,21,0,23,0,21,4,3,3,3,3,3,3,10,5
5,4,20,4,4,4,4,4,4,4,4,4,4,4,4,4,4,4,4,0,0,0,0,0,0,4,4,4,4,20,4,4,22,4,4,4,4,4,4,5
5,3,3,3,3,14,3,3,3,3,3,3,3,3,3,3,3,3,4,0,0,0,0,0,0,21,0,3,3,3,3,3,3,3,3,3,3,3,3,5
5,3,14,3,3,3,3,3,3,14,3,3,3,3,3,3,3,3,4,0,0,0,0,0,0,4,3,3,3,3,3,3,3,3,3,3,3,3,3,5
5,3,3,3,14,3,3,3,3,3,3,3,3,3,3,3,3,3,4,0,0,0,0,0,0,4,4,4,4,4,4,4,4,4,4,4,4,4,3,5
5,14,3,3,3,3,3,3,3,14,3,14,3,3,3,3,3,3,4,0,0,0,0,0,0,4,3,3,3,3,3,10,3,3,3,3,3,10,3,5
5,3,3,14,3,14,3,3,3,3,14,3,3,3,3,3,3,3,4,0,0,0,0,0,0,4,3,3,3,3,10,10,10,3,3,3,3,10,3,5
5,3,14,3,3,3,3,3,3,14,3,3,3,3,0,0,14,0,23,0,0,0,0,0,0,23,3,3,3,3,10,3,3,3,3,3,3,10,3,5
5,4,4,4,4,4,4,4,4,4,4,4,4,4,4,4,4,4,4,20,4,4,4,4,4,4,4,4,4,4,4,4,4,4,4,4,4,4,4,5
5,3,3,3,3,10,3,10,3,3,3,3,3,3,3,3,3,3,3,0,0,0,0,0,0,3,3,3,3,10,3,3,3,3,3,10,3,10,3,5
5,3,3,3,3,10,3,10,3,3,10,3,3,3,3,3,3,3,3,0,0,0,0,0,0,4,3,3,3,10,10,10,10,10,3,3,3,10,3,5
5,10,10,10,10,10,10,10,10,10,10,3,3,3,3,3,3,3,3,0,0,1,0,2,0,4,3,3,3,10,3,3,10,3,3,3,10,10,18,5
5,10,3,3,3,10,10,10,10,10,10,10,10,10,3,3,3,3,3,0,0,0,0,0,0,4,4,3,4,4,4,4,4,4,4,4,4,4,4,5
5,3,10,3,10,3,18,18,3,3,10,3,3,3,3,3,3,3,3,0,0,0,0,0,0,5,3,3,3,3,8,3,3,3,3,3,8,3,3,5
5,3,10,10,3,3,4,10,10,3,3,3,4,3,3,3,3,3,3,0,0,0,0,0,0,5,3,8,3,3,3,3,8,3,3,3,8,3,3,5
5,18,10,10,3,3,4,10,10,3,3,3,4,4,4,4,4,4,4,4,4,4,4,4,4,5,3,3,8,3,8,3,3,3,8,3,3,3,8,5
5,3,10,3,10,3,4,10,10,18,3,10,4,3,3,3,3,3,3,3,3,3,3,3,3,5,8,3,3,3,3,8,3,3,3,3,8,3,3,5
5,3,3,3,3,3,4,3,3,3,10,10,4,7,3,3,3,3,3,3,3,3,3,3,3,5,3,3,3,3,3,3,3,3,3,3,3,18,3,5
5,5,5,5,5,5,5,5,5,5,5,5,5,5,5,5,5,5,5,5,5,5,5,5,5,5,5,5,5,5,5,5,5,5,5,5,5,5,5,5