True
4
0
30,60
4,4,4,4,4,4,4,4,0,0,0,0,0,0,0,0,0,0,0,0,0,0,0,0,0,0,0,0,0,0,0,0,0,0,0,0,0,0,0,0,0,0,0,0,0,0,0,0,0,0,0,0,0,0,0,0,0,0,0,0
1,0,0,0,0,0,0,4,0,0,0,0,0,0,0,0,0,0,0,0,0,0,0,0,0,0,0,0,0,0,0,0,0,0,0,0,0,0,0,0,0,0,0,0,0,0,0,0,0,0,0,0,0,0,0,0,0,0,0,0
2,0,0,0,0,0,0,4,0,0,0,0,0,0,0,0,0,0,0,0,0,0,0,0,0,0,0,0,0,0,0,0,0,0,0,0,0,0,0,0,0,0,0,0,0,0,0,0,0,0,0,0,0,0,0,0,0,0,0,0
4,4,0,0,0,0,0,4,0,0,0,0,0,0,0,0,0,0,0,0,0,0,0,0,0,0,0,0,0,0,0,0,0,0,0,0,0,0,0,0,0,0,0,0,0,0,0,0,0,0,0,0,0,0,0,0,0,0,0,0
0,4,0,0,0,0,0,4,0,0,0,0,0,0,0,0,0,0,0,0,0,0,0,0,0,0,0,0,0,0,0,0,0,0,0,0,0,0,0,0,0,0,0,0,0,0,0,0,0,0,0,0,0,0,0,0,0,0,0,0
0,4,0,0,0,0,0,4,0,0,0,0,0,0,0,0,0,0,0,0,0,0,0,0,0,0,0,0,0,0,0,0,0,0,0,0,0,0,0,0,0,0,0,0,0,0,0,0,0,0,0,0,0,0,0,0,0,0,0,0
0,4,0,0,0,0,0,4,0,0,0,0,0,0,0,0,0,0,0,0,0,0,0,0,0,0,0,0,0,0,0,0,0,0,0,0,0,0,0,0,0,4,4,4,4,4,4,4,4,4,4,4,4,4,4,4,4,0,0,0
0,4,0,0,0,0,0,4,4,4,4,4,4,4,4,4,4,4,4,4,4,4,4,4,4,0,0,0,0,0,0,0,0,0,0,0,0,0,0,0,0,4,18,3,3,21,0,0,0,0,0,0,0,0,0,0,4,0,0,0
0,4,0,0,0,0,0,0,0,0,0,0,0,0,0,0,0,0,0,0,0,0,0,0,4,0,0,0,0,0,0,0,0,0,0,0,0,0,0,0,0,4,3,3,10,4,0,0,0,0,0,0,0,0,0,7,4,0,0,0
0,4,0,0,0,0,0,0,0,0,0,0,0,0,0,0,0,0,0,0,0,0,0,0,4,0,0,0,0,0,0,0,0,0,0,0,0,0,0,0,0,4,3,10,10,4,3,3,3,5,4,4,4,4,4,4,4,0,0,0
0,4,0,0,0,0,0,0,0,0,0,0,0,0,0,0,0,0,0,0,0,0,0,0,4,0,0,0,0,0,0,0,0,0,0,0,0,0,0,0,0,4,10,10,3,4,3,3,3,5,0,0,0,0,0,0,0,0,0,0
0,4,4,4,4,4,4,4,4,4,4,4,4,0,4,4,4,4,4,4,4,4,4,4,4,4,4,4,4,0,0,0,0,0,0,0,0,0,0,0,0,4,10,3,3,4,3,3,3,5,0,0,0,0,0,0,0,0,0,0
0,0,0,0,0,0,0,0,0,0,0,4,3,3,3,3,3,3,3,3,3,3,3,3,0,0,0,0,4,0,0,0,0,0,0,0,0,0,0,0,0,4,10,3,0,23,3,3,3,5,0,0,0,0,0,0,0,0,0,0
0,0,0,0,0,0,0,0,0,0,0,4,3,3,3,3,3,3,4,3,3,3,3,3,0,0,0,0,4,0,0,0,0,0,0,0,0,0,0,0,0,4,4,4,4,5,10,10,10,5,0,0,0,0,0,0,0,0,0,0
0,0,0,0,0,0,0,0,0,0,0,4,3,10,10,3,10,10,4,4,4,4,4,4,0,0,0,0,4,0,0,0,0,0,0,0,0,0,0,0,0,0,0,0,0,5,3,3,3,5,0,0,0,0,0,0,0,0,0,0
0,0,0,0,0,0,0,0,0,0,0,4,3,3,3,10,3,3,4,3,3,3,18,4,0,0,0,0,4,0,0,0,0,0,0,0,0,0,0,0,0,0,0,0,0,5,10,10,10,5,0,0,0,0,0,0,0,0,0,0
0,0,0,0,0,0,0,0,0,0,0,4,3,3,3,10,3,18,4,3,3,3,3,4,0,0,0,0,4,0,0,0,0,0,0,0,0,0,0,0,0,0,0,0,0,5,3,14,3,5,0,0,0,0,0,0,0,0,0,0
4,4,4,4,4,0,0,0,0,0,0,5,4,4,4,4,4,4,4,10,10,10,10,4,0,0,0,0,4,0,0,0,0,0,0,0,0,0,0,0,0,0,0,0,0,5,10,10,10,5,0,0,0,0,0,0,0,0,0,0
4,0,0,18,4,0,0,0,0,0,0,5,3,3,3,10,3,3,3,3,3,3,3,4,0,0,0,0,4,0,0,0,0,0,0,0,0,0,0,0,0,0,0,0,0,5,3,3,3,5,0,0,0,0,0,0,0,0,0,0
4,0,0,5,4,0,0,0,0,0,0,5,3,10,3,3,3,10,3,3,3,10,3,4,0,0,0,0,4,0,0,0,0,0,0,0,0,0,0,0,0,0,0,0,0,5,10,10,10,5,0,0,0,0,0,0,0,0,0,0
4,0,0,0,4,0,0,0,0,0,0,5,3,10,3,3,10,10,3,10,3,10,3,4,0,0,0,0,4,0,0,0,0,0,0,0,0,0,0,0,0,0,0,0,0,5,3,3,3,5,0,0,0,0,0,0,0,0,0,0
4,0,0,0,4,4,4,4,4,4,4,4,3,3,10,3,3,3,10,10,3,3,10,4,0,0,0,0,4,4,4,4,4,4,4,4,4,4,4,4,4,4,4,4,4,5,10,10,10,5,0,0,0,0,0,0,0,0,0,0
4,0,0,0,3,4,4,4,10,4,0,0,3,3,3,3,10,3,3,3,10,3,3,3,0,14,0,0,0,10,10,10,10,0,0,0,0,4,0,0,0,0,0,0,3,10,3,3,3,5,0,0,0,0,0,0,0,0,0,0
4,0,0,0,3,0,0,0,3,0,0,4,3,3,10,3,3,3,3,3,3,10,3,3,0,0,0,0,0,3,10,10,10,10,10,3,10,3,0,0,0,0,0,0,3,10,10,10,10,5,0,0,0,0,0,0,0,0,0,0
4,0,0,0,3,4,4,4,4,4,4,4,3,3,3,3,10,10,3,3,3,3,3,3,0,0,0,0,0,3,10,10,10,10,10,3,10,10,0,0,0,0,10,0,3,10,3,3,3,5,0,0,0,0,0,0,0,0,0,0
4,0,0,0,3,0,0,0,0,0,0,21,3,10,3,3,3,3,8,3,3,3,3,3,0,0,0,0,0,3,3,10,10,10,10,3,10,10,3,0,0,10,10,10,3,10,3,3,3,5,0,0,0,0,0,0,0,0,0,0
5,5,5,5,5,5,5,5,5,5,5,5,5,5,5,5,5,5,5,5,5,5,5,5,5,5,5,5,5,5,5,5,5,5,5,5,5,5,5,5,5,5,5,5,5,5,5,5,5,5,0,0,0,0,0,0,0,0,0,0
0,0,0,0,0,0,0,0,0,0,0,0,0,0,0,0,0,0,0,0,0,0,0,0,0,0,0,0,0,0,0,0,0,0,0,0,0,0,0,0,0,0,0,0,0,0,0,0,0,0,0,0,0,0,0,0,0,0,0,0
0,0,0,0,0,0,0,0,0,0,0,0,0,0,0,0,0,0,0,0,0,0,0,0,0,0,0,0,0,0,0,0,0,0,0,0,0,0,0,0,0,0,0,0,0,0,0,0,0,0,0,0,0,0,0,0,0,0,0,0
0,0,0,0,0,0,0,0,0,0,0,0,0,0,0,0,0,0,0,0,0,0,0,0,0,0,0,0,0,0,0,0,0,0,0,0,0,0,0,0,0,0,0,0,0,0,0,0,0,0,0,0,0,0,0,0,0,0,0,0